Жоғары Еуразиялық экономикалық кеңестің 2018 жылғы 6 желтоқсандағы № 28 шешімімен бекітілген "Еуразиялық экономикалық одақтың дамуына қосқан үлесі үшін" медалі туралы ереженің 3-тармағына сәйкес, Еуразиялық экономикалық одақтың дамуына елеулі үлес қосқан Еуразиялық экономикалық одаққа мүше мемлекеттердің азаматтарын көтермелеу мақсатында Жоғары Еуразиялық экономикалық кеңес шешті:

Қосымшаға сәйкес тізім бойынша Еуразиялық экономикалық одаққа мүше мемлекеттердің азаматтары "Еуразиялық экономикалық одақтың дамуына қосқан үлесі үшін" медалімен наградталсын.

Жоғары Еуразиялық экономикалық кеңестің мүшелері:

Армения Республикасынан	|	Беларусь Республикасынан	|	Қазақстан Республикасынан	|	Қырғыз Республикасынан	|	Ресей Федерациясынан


	|	Жоғары Еуразиялық экономикалық кеңестің 2022 жылғы 9 желтоқсандағы № 16 шешіміне
	|	ҚОСЫМША

Еуразиялық экономикалық одаққа мүше мемлекеттердің "Еуразиялық экономикалық одақтың дамуына қосқан үлесі үшін" медалімен наградталатын азаматтарының ТІЗІМІ
Армения Республикасынан
АГИНЯН Сергей Левонович – Армения Республикасының Қоғамдық қызметтерді реттеу жөніндегі комиссиясының мүшесі

МАРТИРОСЯН Артур Мельсикович – Армения Республикасы Білім, ғылым, мәдениет және спорт министрінің орынбасары

МУРАДЯН Ашот Оганесович – Армения Республикасы Мемлекеттік кіріс комитеті төрағасының орынбасары

НАГАПЕТЯН Давид Робертович – Армения Республикасы Орталық Банкі кеңесінің мүшесі

НАНУШЯН Лена Мануковна – Армения Республикасы Денсаулық сақтау министрінің бірінші орынбасары

ОГАННИСЯН Давид Алексанович – Армения Республикасының Бәсекелестікті қорғау комиссиясы Бас хатшысының орынбасары

СИМОНЯН Армен Оганесович – Армения Республикасы Аумақтық басқару және инфрақұрылым министрінің орынбасары

СИМОНЯН Варос Арутюнович – Армения Республикасы Экономика министрінің орынбасары (2019 – 2021 жылдар аралығы)

Беларусь Республикасынан
ГЛОВИНСКАЯ Ольга Анатольевна – Беларусь Республикасы Мемлекеттік кеден комитетінің Кедендік бақылауды ұйымдастыру Бас басқармасының кедендік бақылаумен өткізу бөлімінің бас инспекторы

ЕЖОВА Марина Юрьевна – Беларусь Республикасы Экономика министрлігінің Экономикалық интеграция Бас басқармасының бастығы

ЕСИНА Ирина Владимировна – Беларусь Республикасы Экономика министрлігі Экономикалық интеграция бас басқармасы бастығының орынбасары – нарықтарды интеграциялау басқармасының бастығы

ЗАХАРЕЕВА Мария Сергеевна – Беларусь Республикасы Министрлер Кеңесі Аппаратының Халықаралық ынтымақтастық және сауда Бас басқармасы сыртқы экономикалық қызмет басқармасының бас кеңесшісі

ЗУБРИЦКАЯ Татьяна Николаевна – Әзербайжан Республикасындағы Беларусь Республикасы Елшілігінің кеңесшісі

МАЙКОВСКИЙ Вячеслав Станиславович – Беларусь Республикасы Салық және алымдар министрлігі тауарлар мен көрсетілетін қызметтерді өткізуді бақылау Бас басқармасы электрондық бақылау жүйелері басқармасының бастығы - Бас басқарма бастығының орынбасары

ПРОКОПЧУК Андрей Викторович – Беларусь Республикасы Сыртқы істер министрлігі Сыртқы экономикалық қызмет департаменті сауда келіссөздері және қорғау шаралары басқармасының бастығы - Департамент директорының орынбасары

СЕЛИЦКАЯ Элла Александровна – Беларусь Республикасы Салық және алымдар министрінің орынбасары

СТАТКЕВИЧ Максим Андреевич – Беларусь Республикасы Мемлекеттік кеден комитетінің Халықаралық-құқықтық басқармасы интеграциялық процестер бөлімі бастығының орынбасары

ШУЛЬГА Павел Пантелеевич – Беларусь Республикасы Қаржы министрлігінің Халықаралық қаржы қатынастары Бас басқармасының бастығы

ЯКУСЕВИЧ Татьяна Эдуардовна – "Беларусь мемлекеттік метрология институты" республикалық унитарлық кәсіпорнының машина жасау өнімдері мен қызметтерді сертификаттау бөлімінің бастығы

Қазақстан Республикасынан
ӘБДІЛМАНОВА Жанна Тұяққызы – Қазақстан Республикасы Әділет министрлігінің Халықаралық экономикалық интеграция жөніндегі жобаларды сараптау департаменті директорының орынбасары

АСАНҚҰЛОВА Гүлсім Мамадияқызы – Қазақстан Республикасы Индустрия және инфрақұрылымдық даму министрлігі Интеграция және халықаралық ынтымақтастық департаменті директорының орынбасары

АШИТОВ Серік Батырханұлы – Қазақстан Республикасы Сауда және интеграция министрлігінің Сыртқы сауда қызметі департаменті директорының орынбасары

БЕКІШЕВ Әсет Рысқалиұлы – Қазақстан Республикасы Ұлттық экономика министрлігі Салық және кеден саясаты департаменті Халықаралық салық салу және өзара іс қимыл басқармасының бас сарапшысы

БУРИН Мәди Бауыржанұлы – Қазақстан Республикасы Қаржы нарығын реттеу және дамыту агенттігінің Халықаралық қатынастар және интеграция басқармасының бастығы (2021 - 2022 жылдар аралығы)

ГАРИФУЛЛИНА Дина Маратқызы – Қазақстан Республикасы Сауда және интеграция министрлігі Сыртқы сауда қызметі департаменті Сауда келіссөздері басқармасының басшысы

ЕРМЕКПАЕВА Розалина Асқарқызы – Қазақстан Республикасы Денсаулық сақтау министрлігі Санитариялық-эпидемиологиялық бақылау комитетінің Азық-түлік емес тауарларға техникалық регламенттерді бақылау басқармасының басшысы

ЕСПАЕВ Сағымбай Жолдоғалиұлы – Қазақстан Республикасының Ресей Федерациясындағы Елшілігінің бірінші хатшысы

ЖУМАҚАНОВ Николай Владимирович – Қазақстан Республикасы Сыртқы істер министрлігінің Халықаралық-құқықтық департаментінің директоры

МАДАЛИЕВ Бақытжан Нұржанұлы – Қазақстан Республикасы Сауда және интеграция министрлігі Сыртқы сауда қызметі департаменті Кедендік-тарифтік реттеу басқармасының бас сарапшысы

МАРАЛБАЕВ Бүркіт Зейнел-Набиұлы – Қазақстан Республикасы Сауда және интеграция министрлігі Экономикалық интеграция департаменті Сауданы дамыту басқармасының бас сарапшысы

МҰҚЫШЕВ Алмаз Қайырбекұлы – Қазақстан Республикасы Ұлттық экономика министрлігі Салық және кеден саясаты департаменті Кеден саясаты басқармасының бас сарапшысы

МҰХАНОВА Гүлнар Жанетқызы – Қазақстан Республикасы Денсаулық сақтау министрлігі Халықаралық ынтымақтастық және интеграция департаментінің директоры

НҰРБЕК Олжас Бауыржанұлы – Қазақстан Республикасы Сауда және интеграция министрлігі Экономикалық интеграция департаменті интеграцияны дамыту басқармасының басшысы

НҰРТАЗИНА Гүлжан Сабырқызы – Қазақстан Республикасы Ауыл шаруашылығы министрлігі Ветеринариялық бақылау және қадағалау комитеті төрағасының орынбасары

СИНЯГОВСКИЙ Александр Сергеевич – Қазақстан Республикасының Ресей Федерациясындағы Елшілігінің кеңесші-елшісі

СҰЛТАНОВ Бақыт Тұрлыханұлы -Қазақстан Республикасы Премьер-Министрінің орынбасары – Сауда және интеграция министрі (2022 жылы)

СЫЗДЫҚОВА Эльмира Жақсылыққызы - Қазақстан Республикасы Сауда және интеграция министрлігі Сыртқы сауда қызметі департаменті Қорғау шаралары басқармасының басшысы

ТОҚАН Диас Ерболұлы – Қазақстан Республикасы Сауда және интеграция министрлігі Экономикалық интеграция департаменті Кәсіпкерлік саласындағы ынтымақтастықты дамыту басқармасының бас сарапшысы

Қырғыз Республикасынан
АБДЫЛДАЕВ Акылбек Талайбекович – Қырғыз Республикасының Ресей Федерациясындағы Елшілігінің бірінші хатшысы

АБДЫМОМУНОВА Галия Кошоевна – Қырғыз Республикасы Экономика және коммерция министрлігі Техникалық реттеу және метрология басқармасының сәйкестікті бағалау бөлімінің меңгерушісі

АЛИМЖАНОВА Диляна Рустамовна – Қырғыз Республикасы Экономика және коммерция министрлігі ЕАЭО үйлестіру басқармасының интеграцияны дамыту бөлімінің меңгерушісі

АМАТОВ Эдильбек Алмазбекович – Қырғыз Республикасы Сыртқы істер министрлігі Экономикалық дипломатия департаментінің ЕАЭО секторының үшінші хатшысы

АРТЫКБАЕВ Айбек Мухтарович – Қырғыз Республикасы Сыртқы істер министрінің орынбасары

АРТЫКБАЕВА Нази Адилбековна – Қырғыз Республикасы Әділет министрлігі Экономикалық заңнама басқармасының бас маманы

ИЛЬЯСОВА Нуржамал Сатаровна – Еуразиялық экономикалық комиссияның Кәсіпкерлік қызметті дамыту департаменті директорының орынбасары

ИМАНАЛИЕВ Эркинбек Эмильевич – Қырғыз Республикасы Қаржы министрлігі жанындағы Мемлекеттік кеден қызметінің тәуекелдерді талдау және тәуекел басқармасының бастығы

КААРБАЕВА Назгуль Токтогуловна – Қырғыз Республикасы Ауыл шаруашылығы министрлігінің Еуразиялық экономикалық одақпен жұмыс және Дүниежүзілік сауда ұйымының мәселелері жөніндегі бөлім меңгерушісі

КАРМЫШАКОВ Улукбек Тойчуевич – Венгрия-қырғыз Даму Қоры Басқарма төрағасының орынбасары

КУРМАНОВ Нурлан Дамирович – Қырғыз Республикасы Сыртқы істер министрлігінің Сегізінші саяси департаментінің Экономикалық интеграция бөлімінің кеңесшісі (2018 - 2022 жылдар аралығы)

КЫЛЫЧБЕКОВА Алима Зарылбековна – Қырғыз Республикасы Президенті Әкімшілігінің Президент және Министрлер Кабинеті шешімдерін дайындау басқармасының ЕАЭО істері жөніндегі бөлімінің сарапшысы

МАМБЕТЖУНУШЕВА Элнура Рыскелдиевна – Қырғыз Республикасы Қаржы министрлігі жанындағы Мемлекеттік кеден қызметі төрағасының орынбасары

МАМЫТОВА Акмаанай Чолпонбековна – Қырғыз Республикасы Экономика және коммерция министрлігі ЕАЭО үйлестіру басқармасының интеграцияны дамыту бөлімінің бас маманы

ПРАТОВА Нурпери Манасовна – Қырғыз Республикасы Цифрлық даму министрлігі жанындағы "Инфоком" мемлекеттік кәсіпорнының жетекші талдаушысы

РАЕВА Эльгиза Султанбаевна – Қырғыз Республикасы Президенті Әкімшілігінің ЕАЭО істері жөніндегі бөлімінің сарапшысы (2018 - 2021 жылдар аралығы)

УМТУЛОВ Нурлан Джумалиевич – Қырғыз Республикасы Қаржы министрлігі жанындағы Мемлекеттік салық қызметі төрағасының орынбасары

ХУДАЙБЕРГЕНОВ Султан Азаматович – Қырғыз Республикасының Германия Федеративтік Республикасындағы Елшілігінің бірінші хатшысы

ЧЫНЫБАЕВ Исламбек Адамкулович – Қырғыз Республикасы Президенті Әкімшілігінің Президент және Министрлер Кабинеті шешімдерін дайындау басқармасының ЕАЭО істері жөніндегі бөлімінің сарапшысы

ШАБДАНОВ Бакытбек Касмалиевич – Қырғыз Республикасы Экономика және коммерция министрлігі Техникалық реттеу және метрология басқармасының бастығы

ШАМИЛЕВ Элмурат Шамилевич – Қырғыз Республикасы Қаржы министрлігі жанындағы Мемлекеттік кеден қызметі Кеден ынтымақтастығы Басқармасының ЕАЭО мәселелері жөніндегі бөлімінің бастығы

Ресей Федерациясынан
АМЕЛЬЯНОВИЧ Сергей Алексеевич – Федералдық кеден қызметінің Кедендік ресімдеуді және кедендік бақылауды ұйымдастыру Бас басқармасы бастығының бірінші орынбасары

АНАНЬЕВА Александра Алексеевна – Ресей Федерациясы Өнеркәсіп және сауда министрлігінің Еуропа, Солтүстік Америка, ТМД елдері және көпжақты экономикалық ынтымақтастық департаменті еуразиялық интеграция бөлімінің жетекші кеңесшісі

АНИСИМОВ Михаил Валериевич – Ресей Федерациясы Өнеркәсіп және сауда министрлігінің Еуропа, Солтүстік Америка, ТМД және көпжақты экономикалық ынтымақтастық департаментінің директоры

БАБИЧ Михаил Викторович – Әскери-техникалық ынтымақтастық жөніндегі федералдық қызмет директорының орынбасары

БАКИНА Алла Станиславовна – Ресей Федерациясы Орталық Банкінің Ұлттық төлем жүйесі департаментінің директоры

ВОЛЬВАЧ Дмитрий Валерьевич – Ресей Федерациясының Экономикалық даму министрінің орынбасары

ГУЛИНА Юлия Владимировна – Ресей Федерациясы Экономикалық даму министрлігі Еуразиялық интеграция департаментінің ЕАЭО-дағы ұлттықтан жоғары институттарды дамыту бөлімінің бастығы

ДОБКИН Алексей Геннадьевич – Ресей Федерациясы Экономикалық даму министрлігінің Еуразиялық интеграция департаментінің директоры

ИВИН Владимир Владимирович – Федералдық кеден қызметі басшысының орынбасары

КУЗНЕЦОВ Виктор Игоревич – Ресей Федерациясы Үкіметінің Халықаралық ынтымақтастықты дамыту департаментінің директоры

МАЛЬКОВА Виктория Валерьевна – Ресей Федерациясы Сыртқы істер министрлігінің ТМД елдерінің бірінші департаменті директорының орынбасары

НЕВЕРОВ Игорь Святославович – Ресей Федерациясы Сыртқы істер министрлігінің ТМД елдерінің бірінші департаменті директорының орынбасары

ОВЕРЧУК Алексей Логвинович – Ресей Федерациясы Үкіметі Төрағасының орынбасары

РЕШЕТНИКОВ Максим Геннадьевич – Ресей Федерациясының Экономикалық даму министрі

СОЗОНОВА Елена Юрьевна – Ресей Федерациясының Экономикалық даму министрлігі ТМД елдерімен экономикалық ынтымақтастық департаментінің аймақаралық ынтымақтастықты дамыту бөлімінің кеңесшісі

СОКОЛОВ Сергей Александрович – Ресей Федерациясы Президенті Әкімшілігінің Сыртқы саясат жөніндегі Ресей Федерациясы Президенті басқармасының референті

СПИЦЫНА Ольга Михайловна – Ресей Федерациясы Қаржы министрлігінің Кедендік саясат және алкоголь нарығын реттеу департаментінің кедендік әкімшілендіру бөлімінің бастығы

ТАЛЕЕВА Дарина Александровна – Ресей Федерациясы Ауыл шаруашылығы министрлігінің Өсімдік шаруашылығы, механикаландыру, химияландыру және өсімдіктерді қорғау департаментінің карантин, өсімдіктерді қорғау және тұқым шаруашылығы бөлімінің бастығы

ФАСТОВА Елена Владимировна – Ресей Федерациясы Ауыл шаруашылығы министрінің орынбасары

ШАМУГИЯ Ира Шалериевна – Ресей Федерациясы Сыртқы істер министрлігінің ТМД елдерінің бірінші департаментінің атташесі

ШИШЛЯННИКОВА Ольга Юрьевна – Ресей Федерациясының Орталық банкінің Инвестициялық қаржы делдалдары департаментінің директоры

Еуразиялық экономикалық комиссиядан
Еуразиялық экономикалық комиссия кеңесінің мүшелері, Еуразиялық экономикалық комиссия Алқасының мүшелері, Еуразиялық экономикалық комиссияның лауазымды адамдары мен қызметкерлері
АЖЕКБАРОВ Каныбек – Макроэкономикалық саясат департаменті директорының орынбасары

АСАНБЕКОВ Темирбек Ишенбаевич – Энергетика және инфрақұрылым жөніндегі алқа мүшесі (Министр) (2021 - 2022 жылдар аралығы)

БАКЕНОВ Ернар Багытжанулы – Бәсекелестік және монополияға қарсы реттеу жөніндегі алқа мүшесінің (Министрдің) көмекшісі

БАННЫХ Игорь Николаевич – Кеден инфрақұрылымы департаментінің кеден инфрақұрылымын дамыту бөлімінің кеңесшісі

БАРСЕГЯН Гоар Ашотовна – Интеграцияны дамыту департаментінің директоры

БУЦЬ Анна Александровна – Агроөнеркәсіптік саясат департаменті аграрлық нарықтарды дамыту бөлімі бастығының орынбасары

ВЛАДИМИРОВ Сергей Валентинович – Кеден заңнамасы және құқық қолдану практикасы департаментінің директоры

ГЛАЗЬЕВ Сергей Юрьевич – Интеграция және макроэкономика жөніндегі алқа мүшесі (Министр)

ГРИГОРЯН Мгер Гербертович – Кеңес мүшесі, Армения Республикасының Вице-премьер-министрі

ДИЯНСКИЙ Андрей Вадимович – Интеграция және макроэкономика жөніндегі алқа мүшесі (Министр) Хатшылығының басшысы

ЕСАЯН Давид Самвелович – Ішкі нарықтар, ақпараттандыру, ақпараттық-коммуникациялық технологиялар жөніндегі алқа мүшесінің (Министрдің) көмекшісі

ЖАҚСЫЛЫҚ Данияр Елубайұлы – Хаттама және ұйымдастырушылық қамтамасыз ету департаменті директорының орынбасары (2018 - 2022 жылдар аралығы)

ЖУКОВСКИЙ Павел Васильевич – Бәсекелестік саясат және мемлекеттік сатып алу саласындағы саясат департаменті директорының орынбасары

ЗАЙЦЕВА Светлана Викторовна – Энергетика департаментінің Электр энергетикасы және атом саясаты бөлімінің бастығы

ЗАХАРОВ Андрей Владимирович – Ішкі нарықты қорғау департаментінің директоры

КАЗАРЯН Ваагн Рудольфович – Кедендік-тарифтік және тарифтік емес реттеу департаментінің директоры

КАМАЛЯН Артак Каджикович – Өнеркәсіп және агроөнеркәсіптік кешен жөніндегі алқа мүшесі (Министр)

КРОХИН Павел Владимирович – Санитариялық, фитосанитариялық және ветеринариялық шаралар департаментінің ветеринариялық шаралар бөлімінің кеңесшісі

ЛЕДОВСКИХ Светлана Юрьевна – Өнеркәсіп және агроөнеркәсіптік кешен жөніндегі алқа мүшесі (Министр) Хатшылығының басшысы

МАКСУДЯН Лили Погосовна – Техникалық реттеу және аккредиттеу департаменті директорының орынбасары

МАМЫТКАНОВ Максат Суйуналиевич – Кедендік ынтымақтастық жөніндегі алқа мүшесі (Министр)

МОРОЧКОВА Зоя Михайловна – Интеграцияны дамыту департаментінің талдау және перспективалық даму бөлімінің бастығы

МЯСНИКОВИЧ Михаил Владимирович – Алқа Төрағасы

НАСУТА Сергей Викторович – Қаржы саясаты департаментінің бюджеттік саясат саласындағы төлемдер және үйлестіру бөлімінің бастығы

ПАВЛОВА Ирина Николаевна – Энергетика департаментінің мұнай-газ саясаты бөлімінің бастығы

ПАСТУШЕНКО Наталья Вячеславовна – Кеден заңнамасы және құқық қолдану практикасы департаменті кеден заңнамасы бөлімінің кеңесшісі

ПЕРМИНОВА Елена Александровна – Ішкі нарықтардың жұмыс істеуі департаменті директорының орынбасары

ПЕТРИШЕНКО Игорь Викторович – Кеңес мүшесі, Беларусь Республикасы Премьер-Министрінің орынбасары

САВРО Елизавета Эдуардовна – Қаржы департаменті директорының орынбасары

САРЫБАЕВ Чингиз Абдусатарович – Еңбек көші-қоны және әлеуметтік қорғау департаментінің еңбек ресурстары бөлімінің бастығы

СУШКЕВИЧ Алексей Геннадьевич – Монополияға қарсы реттеу департаментінің директоры

ХИЗРИЕВ Назим Дарвинович – Істерді басқару департаментінің әкімшілік-шаруашылық қызмет бөлімінің бастығы

ЧЕРНЫШЕВ Сергей Владимирович – Сауда жөніндегі алқа мүшесінің (Министрдің) көмекшісі

ШАРИПОВА Динара Хайрулловна – Көлік және инфрақұрылым департаменті су және әуе көлігі бөлімінің бастығы

ШУМИЛИН Дмитрий Вадимович – Өнеркәсіптік саясат департаментінің өнеркәсіптік саясат, мемлекетаралық бағдарламалар және жобалар бөлімінің бастығы

ЩЕРБИН Павел Григорьевич – Алқа Төрағасының көмекшісі

ЮЛЕГИН АртҰм Александрович – Кәсіпкерлік қызметті дамыту департаменті кәсіпкерлікті адвокаттандыру бөлімінің бастығы

Еуразиялық экономикалық одақ Сотынан
АБДУЛЛИНА Гульмира Бахитжановна – Сот судьясының кеңесшісі

АДЕРЕЙКО Александр Николаевич – Сот судьясының кеңесшісі

БУДНИК Ярослав Владимирович – Сот судьясының кеңесшісі

ВИННИК Владимир Владимирович – Сот судьясының көмекшісі

ДЬЯЧЕНКО Екатерина Борисовна – Сот судьясының кеңесшісі

ЕДЕЛЬКИНА Елена Викторовна – Сот Хатшылығының қаржы және ұйымдастыру-кадр жұмысы бөлімінің кадр жұмысы және қауіпсіздік жөніндегі кеңесшісі

КУЛЕШ Николай Николаевич – Сот Хатшылығының басшысы

МЫСЛИВСКИЙ Павел Петрович – Сот судьясының кеңесшісі

ПРОШИНА Оксана Юрьевна – Сот Хатшылығының қаржы және ұйымдастыру-кадр жұмысы бөлімінің кеңесшісі

РАФАЛЮК Елена Евгеньевна – Сот Хатшылығының сараптамалық-талдау бөлімінің кеңесшісі

РЕЗВАНОВА Ольга Александровна – Сот судьясының кеңесшісі

СИМОНЯН Грачья Владимирович – Сот судьясының кеңесшісі

ТИХОНЕНКО Светлана Владимировна – Сот Хатшылығының қаржы және ұйымдастыру-кадр жұмысы бөлімінің кеңесшісі

ЭНТИН Кирилл Владимирович – Сот Хатшылығы басшысының орынбасары - Соттың сараптамалық-талдау бөлімінің бастығы

ЯЛОВИЧ Андрей Николаевич – Сот Хатшылығының қаржы және ұйымдастыру-кадр жұмысы бөлімінің кеңесшісі

