Жоғары Еуразиялық экономикалық кеңестің 2014 жылғы 23 желтоқсандағы № 107 шешімімен бекітілген "Еуразиялық экономикалық одақты құруға қосқан үлесі үшін" медалі туралы ереженің 4-тармағына сәйкес, Еуразиялық экономикалық одаққа мүше мемлекеттердің Еуразиялық экономикалық одақты құруға және дамытуға елеулі үлес қосқан азаматтарын көтермелеу мақсатында Жоғары Еуразиялық экономикалық кеңес шешті:

"Еуразиялық экономикалық одақты құруға қосқан үлесі үшін" медалімен мыналар марапатталсын:



I дәрежелі медалімен Беларусь Республикасынан



БОРИСЮК Сергей Валерьевич – Беларусь Республикасы Мемлекеттік кеден комитеті Төрағасының орынбасары

КУДАСОВ Антон Эдмундович – Беларусь Республикасы Экономика министрінің орынбасары

МАТЮШЕВСКИЙ Василий Станиславович – Беларусь Республикасы Премьер-министрінің Бірінші орынбасары, Еуразиялық экономикалық комиссия Кеңесінің Төрағасы

МИХНЕВИЧ Александр Юрьевич – Беларусь Республикасы Сыртқы істер министрінің бірінші орынбасары

НАЗАРЕНКО Виктор Владимирович – Беларусь Республикасы Мемлекеттік стандарттау комитетінің Төрағасы

ПЕТРИШЕНКО Игорь Викторович – Беларусь Республикасының Ресей Федерациясындағы Төтенше және Өкілетті Елшісі

РУМАС Сергей Николаевич – "Беларусь Республикасы Даму Банкі" ашық акционерлік қоғамы басқармасының Төрағасы

ТУШИНСКИЙ Игорь Геронинович – Беларусь Республикасы Әділет министрінің орынбасары



Қазақстан Республикасынан



ӘЗІМОВА Эльвира Әбілхасымқызы – Қазақстан Республикасы Әділет министрінің орынбасары

АЙТЖАНОВА Жанар Сейдахметқызы – Қазақстан Республикасы Экономикалық интеграция істер министрі

ЖАКСЫЛЫҚОВ Тимур Мекешұлы – Қазақстан Республикасы Ұлттық экономика вице-министрі

ЫДЫРЫСОВ Ерлан Әбілфайызұлы – Қазақстан Республикасы Сыртқы істер министрі

КЕЛІМБЕТОВ Қайрат Нематұлы – Қазақстан Республикасы Ұлттық Банкінің Төрағасы

ОРДАБАЕВ Самат Исламұлы – Қазақстан Республикасы Сыртқы істер министрінің орынбасары

РАУ Альберт Павлович – Қазақстан Республикасы инвестициялар және даму вице-министрі

САҒЫНТАЕВ Бақытжан Әбдірұлы – Қазақстан Республикасы Премьер-Министрінің Бірінші орынбасары, Еуразиялық экономикалық комиссия Кеңесінің мүшесі

ШӨКЕЕВ Өмірзақ Естайұлы – "Самұрық-Қазына" Ұлттық әл-ауқат қоры" акционерлік қоғамы басқармасының Төрағасы



Ресей Федерациясынан



БЕЛЬЯНИНОВ Андрей Юрьевич – Федералдық кеден қызметінің басшысы

ГЛАЗЬЕВ Сергей Юрьевич – Ресей Федерациясы Президентінің кеңесшісі

ДВОРКОВИЧ Аркадий Владимирович – Ресей Федерациясы Үкіметі Төрағасының Орынбасары

ЕВТУХОВ Виктор Леонидович – Ресей Федерациясы Өнеркәсіп және сауда министрінің статс-хатшысы – орынбасары

ЛАВРОВ Сергей Викторович – Ресей Федерациясы Сыртқы істер министрі

ЛИХАЧЕВ Алексей Евгеньевич – Ресей Федерациясы Экономикалық даму министрінің орынбасары

ПРИХОДЬКО Сергей Эдуардович – Ресей Федерациясы Үкіметі Төрағасының Орынбасары – Ресей Федерациясы Үкіметі Аппаратының Басшысы

УЛЮКАЕВ Алексей Валентинович – Ресей Федерациясы Экономикалық даму министрі

УШАКОВ Юрий Викторович – Ресей Федерациясы Президентінің көмекшісі

ШУВАЛОВ Игорь Иванович – Ресей Федерациясы Үкіметі Төрағасының Бірінші орынбасары, Еуразиялық экономикалық комиссия Кеңесінің мүшесі



Еуразиялық экономикалық комиссиядан



АЛДАБЕРГЕНОВ Нұрлан Шадыбекұлы – Бәсекелестік және монополияға қарсы реттеу алқасының мүшесі (Министрі)

АХМЕТОВ Даниал Кенжетайұлы – Шығыс Қазақстан облысының әкімі

ВАЛОВАЯ Татьяна Дмитриевна – Интеграцияның негізгі бағыттары және макроэкономика алқасының мүшесі (Министрі)

ГОШИН Владимир Анатольевич – Кедендік ынтымақтастық алқасының мүшесі (Министрі)

КОРЕШКОВ Валерий Николаевич – Техникалық реттеу мәселелері алқасының мүшесі (Министрі)

МАНСҰРОВ Таир Аймұхаметұлы – Энергетика және инфрақұрылым алқасының мүшесі (Министрі)

СИДОРСКИЙ Сергей Сергеевич – Өнеркәсіп және агроөнеркәсіптік кешен алқасының мүшесі (Министрі)

СЛЕПНЕВ Андрей Александрович – Сауда алқасының мүшесі (Министрі)

СҮЛЕЙМЕНОВ Тимур Мұратұлы – Экономика және қаржы саясаты алқасының мүшесі (Министрі)

ХРИСТЕНКО Виктор Борисович – Алқа Төрағасы



II дәрежелі медалімен: Беларусь Республикасынан



АРТЕМЬЕВ Алексей Алексеевич – Беларусь Республикасы Мемлекеттік кеден комитеті Кеден одағы мәселелері жөніндегі құқықтық басқарма бастығының орынбасары

БРОДОВ Роман Павлович – Беларусь Республикасы Экономика министрлігі Сыртқы экономикалық саясат бас басқармасының бастығы

ГУРЕВИЧ Валерий Львович – Беларусь Республикасы Мемлекеттік стандарттау комитеті Төрағасының бірінші орынбасары

ГУРЬЯНОВ Александр Евгеньевич – Беларусь Республикасы Сыртқы істер министрінің орынбасары

ДАЛИДОВИЧ Сергей Викторович – Беларусь Республикасы Мемлекеттік кеден комитеті Кеден одағы мәселелері жөніндегі ақпараттық технологиялар, кедендік статистика және талдау басқармасы бастығының орынбасары

ДУБРОВСКАЯ Татьяна Валерьевна – Беларусь Республикасы Мемлекеттік кеден комитеті Кеден одағы мәселелері жөніндегі Тарифтік реттеу және кедендік төлемдер басқармасы бастығының орынбасары

ЗАКРЕВСКИЙ Вадим Александрович – Беларусь Республикасы Энергетика министрінің орынбасары

КАЛЕЧИЦА Сергей Валерьевич – Беларусь Республикасы Ұлттық банкі басқармасы Төрағасының орынбасары

КАМЕНКО Василий Борисович – Беларусь Республикасы Салықтар және алымдар министрінің орынбасары

КАНГРО Ирина Степановна – Беларусь Республикасы Ұлттық статистикалық комитеті Төрағасының бірінші орынбасары

КИЙКО Дмитрий Николаевич – Беларусь Республикасы Қаржы министрінің орынбасары

МАРИНИЧ Леонид Адамович – Беларусь Республикасы Ауыл шаруашығы және азық-түлік министрінің бірінші орынбасары

НАЗАРУК Игорь Васильевич – Беларусь Республикасы Сыртқы істер министрлігі Сыртқы экономикалық қызмет департаментінің директоры

ОРЛОВСКИЙ Владимир Николаевич – Беларусь Республикасы Мемлекеттік кеден комитеті Төрағасының орынбасары

ПЛАНИН Андрей Александрович – Беларусь Республикасы Мемлекеттік кеден комитеті Кеден одағы мәселелері жөніндегі кедендік бақылауды ұйымдастыру басқармасы бастығының орынбасары

ПОЛУДЕНЬ Сергей Анатольевич – Беларусь Республикасы Мемлекеттік кеден комитеті Төрағасының орынбасары

РЕДНЕНКО Сергей Валентинович – Беларусь Республикасы Мемлекеттік кеден комитеті Төрағасының бірінші орынбасары

СВИДЕРСКИЙ Геннадий Брониславович – Беларусь Республикасы Өнеркәсіп министрінің бірінші орынбасары

СЕДИН Василий Алексеевич – Беларусь Республикасы Ауыл шаруашылығы және азық-түлік министрінің орынбасары

СЕЛИЦКАЯ Элла Александровна – Беларусь Республикасы Салықтар және алымдар министрінің орынбасары

СИЛКОВ Сергей Викторович – Беларусь Республикасының Ресей Федерациясындағы Елшілігінің кеңесші-елшісі

СУНДУКОВА Алла Чарльзовна – Беларусь Республикасы Салықтар және алымдар министрлігі Халықаралық салықтық ынтымақтастық басқармасының бастығы

ФИЛИМОНОВА Елена Владимировна – Беларусь Республикасы Әділет министрлігі Халықаралық ынтымақтастық басқармасы бастығының орынбасары

ФОМИН Игорь Алексеевич – Беларусь Республикасы Экономика министрлігі Баға саясаты департаментінің директоры

ШЕВЧУК Валерий Евгеньевич – Беларусь Республикасы Денсаулық сақтау министрінің орынбасары – Денсаулық сақтау министрлігі Фармацевтикалық өнеркәсіп департаментінің директоры

ШЕДКО Дмитрий Геннадьевич – Беларусь Республикасы Байланыс және ақпараттандыру министрінің бірінші орынбасары

ШУМИЛИН Александр Геннадьевич – Беларусь Республикасы Ғылым және технологиялар жөніндегі Мемлекеттік комитет Төрағасы



Қазақстан Республикасынан



ӘБІЛҚАСЫМОВА Мәдина Ерасылқызы – Қазақстан Республикасы Ұлттық экономика вице-министрі

БАЙЖҮНІСОВ Ерік Әбенұлы – "Республикалық денсаулық сақтауды дамыту орталығы" шаруашылық жүргізу құқығындағы Республикалық мемлекеттік кәсіпорынның бас директоры

БАЙМОЛДИНА Зауреш Хамитқызы – Қазақстан Республикасы Әділет министрінің орынбасары

БАКЕНОВ Ернар Бақытжанұлы – Қазақстан Республикасы Ұлттық экономика министрлігі Халықаралық экономикалық интеграция департаментінің директоры

БЕКТҰРОВ Азат Ғаббасұлы – "Қазаэронавигация" Республикалық мемлекеттік кәсіпорнының бас директоры

ДӘЛЕНОВ Руслан Ерболатұлы – Қазақстан Республикасының Қаржы вице-министрі

ЖАҚСАЛИЕВ Бахытжан Мұхамбетқалиұлы – Қазақстан Республикасының Энергетика вице-министрі

ДҮЙСЕБАЕВ Асылбек Жексенбайұлы – Қарағанды облысы әкімінің бірінші орынбасары

ЖАЙЛАУБАЙ Ерлан Дүйсенбекұлы – Қазақстан Республикасы Президенті Әкімшілігі Сыртқы саясат орталығының сектор меңгерушісі

ЖАҚЫПОВА Светлана Қабыкенқызы – Қазақстан Республикасы Денсаулық сақтау және әлеуметтік даму вице-министрі

ЖҮНІСОВА Дана Бейсенқызы – Қазақстан Республикасы Ұлттық кәсіпкерлер палатасы экономикалық интеграция департаментінің директоры

ИСАЕВА Гүлмира Сұлтанбайқызы – Қазақстан Республикасы Ауыл шаруашылығы вице-министрі

ҚАДЖИАҚБАРОВ Нұржан Қажымұратұлы – Қазақстан Республикасы Президенті Әкімшілігі Сыртқы саясат орталығы меңгерушісінің орынбасары

ҚАНЕШЕВ Біржан Бисекенұлы – Қазақстан Республикасы Инвестициялар және даму министрлігі Техникалық реттеу және метрология комитетінің төрағасы

ҚАСЫМБЕК Жеңіс Махмұдұлы – Қазақстан Республикасы Инвестициялар және даму бірінші вице-министрі

ҚОЖАҚОВ Асан Егінбайұлы – Қазақстан Республикасы Сыртқы істер министрлігінің Айрықша тапсырмалар жөніндегі Елшісі

КӨМЕКБАЕВ Әли Амантайұлы – Қазақстан Республикасы Мемлекеттік қызмет істері және сыбайлас жемқорлыққа қарсы күрес агенттігі Мемлекеттік қызмет және сыбайлас жемқорлық профилактикасы департаментінің басшысы

ҚҰСАЙЫНОВА Айна Біржанқызы – Қазақстан Республикасы Ауыл шаруашылығы министрлігі Экономикалық интеграция және аграрлық азық-түлік нарықтары департаментінің директоры

МАМАШЕВА Дина Талғатқызы – Қазақстан Республикасы Қаржы министрлігі Мемлекеттік кірістер комитеті Кедендік ресімдеу департаментінің директоры

МАТИШЕВ Әлиақпар – Қазақстан Республикасы Ұлттық экономика министрлігі Тұтынушылардың құқықтарын қорғау комитетінің төрағасы

МЫРЗАҒАЛИЕВ Мағзұм Маратұлы – Қазақстан Республикасының Энергетика вице-министрі

МУСИНОВ Серікбол Рахымқанұлы – "Дәрілік заттар, медициналық мақсаттағы бұйымдар мен медициналық техникасы сараптамасы ұлттық орталығы" шаруашылық жүргізу құқығындағы республикалық мемлекеттік кәсіпорнының директоры

НҰРЫМБЕТОВ Біржан Бидайбекұлы – Қазақстан Республикасы Премьер-Министрі Кеңсесі Басшысының орынбасары

ОШАҚБАЕВ Рахым Сәкенұлы – Қазақстан Республикасы Ұлттық кәсіпкерлер палатасы басқармасы төрағасының орынбасары

РАЕВ Олжас Қайырбекұлы – Қазақстан Республикасы Инвестициялар және даму министрлігі Экономикалық интеграция департаментінің директоры

СӘРСЕНБАЕВ Амангелді Өмірбайұлы – Қазақстан Республикасы Жоғарғы Соты Қадағалау сот алқасының судьясы

СЕЙТІМБЕТОВА Сәуле Мырзаханқызы – Қазақстан Республикасы Сыртқы істер министрлігі Еуразиялық интеграция департаментінің директоры

СМАЙЫЛОВ Әлихан Асханұлы – Қазақстан Республикасы Ұлттық экономика министрлігі Статистика комитетінің төрағасы

ТЕҢГЕБАЕВ Ардақ Мырзабайұлы – Қазақстан Республикасы Қаржы вице-министрі

ШОЛПАНҚҰЛОВ Берік Шолпанқұлұлы – Қазақстан Республикасы Қорғаныс министрінің орынбасары



Ресей Федерациясынан



АЛЛИЛУЕВА Ольга Геннадьевна – Тарифтер жөніндегі федералдық қызмет басшысының орынбасары

АРТЕМЬЕВ Игорь Юрьевич – Федералдық монополияға қарсы қызмет басшысы

АСАУЛ Николай Анатольевич – Ресей Федерациясы Көлік министрінің орынбасары

БАРАНОВА Марья Андреевна – Ресей Федерациясы Экономикалық даму министрлігі Сауда келіссөздері департаменті директорының орынбасары

БЕЛЬСКУЯ Елена Владимировна – Ресей Федерациясы Экономикалық даму министрлігі Реттеуші әсерді бағалау департаменті директорының орынбасары

БРАГИНА Ирина Викторовна – Тұтынушылардың құқықтарын қорғау және адамның саламаттығы саласындағы қадағалау жөніндегі федералдық қызмет басшысының орынбасары

ВЛАСОВ Николай Анатольевич – Ветеринариялық және фитосанитариялық қадағалау жөніндегі федералдық қызмет басшысының орынбасары

ГОЛЕНДЕЕВА Татьяна Николаевна – Федералдық кеден қызметі басшысының статс-хатшысы-орынбасары

ДАВЫДОВ Руслан Валентинович – Федералдық кеден қызметі басшысының орынбасары

ДАНКВЕРТ Сергей Алексеевич – Ветеринариялық және фитосанитариялық қадағалау жөніндегі федералдық қызмет басшысы

ЕВДОКИМОВ Михаил Николаевич – Ресей Федерациясы Сыртқы істер министрлігі ТМД елдері Бірінші департаментінің директоры

ЕГОРОВУ Екатерину Юрьевну – Федералдық көші-қон қызметі басшысының статс-хатшысы - бірінші орынбасары

КАДЫРОВА Гульназ Маннуровна – Ресей Федерациясы Өнеркәсіп және сауда министрінің орынбасары

КОСТЕННИКОВ Дмитрий Вячеславович – Ресей Федерациясы Денсаулық сақтау министрінің статс-хатшысы - орынбасары

ЛЯКИШЕВ Дмитрий Владимирович – Ресей Федерациясы Орталық банкі халықаралық ынтымақтастық және қоғамдық коммуникациялар департаментінің директоры

МАЛИНИН Владимир Михайлович – Федералдық кеден қызметі басшысының бірінші орынбасары

МУХОМЕДЖАН Надера Мубиновна – Ресей Федерациясы Үкіметінің Төрағасы Бірінші орынбасары Хатшылығының басшысы

НЕБЕНЗЯ Василий Алексеевич – Ресей Федерациясы Сыртқы істер министрінің орынбасары

РОЗАНОВ Вадим Вадимович – Ресей Федерациясы Үкіметінің Төрағасы Бірінші орынбасары Хатшылығы басшысының орынбасары

РОМОДАНОВСКИЙ Константин Олегович – Федералдық көші-қон қызметінің басшысы

СТОРЧАК Сергей Анатольевич – Ресей Федерациясы Қаржы министрінің орынбасары

СЫСОЕВА Анна Алексеевна – Ресей Федерациясы Экономикалық даму министрлігі Кеден одағы органдарымен өзара іс-қимыл және ТМД елдерімен экономикалық ынтымақтастық департаменті директорының орынбасары

ТАГИРОВ Эльмира Тагирович – Ресей Федерациясы Үкіметі Халықаралық ынтымақтастық департаментінің директоры

ТОПИЛИН Максим Анатольевич – Ресей Федерациясы Еңбек және әлеуметтік қорғау министрі

ТРАВНИКОВ Максим Александрович – Ресей Федерациясы Әділет министрінің орынбасары

ЦЫБУЛЬСКИЙ Александр Витальевич – Ресей Федерациясы Экономикалық даму министрінің орынбасары

ЦЫГАНОВ Андрей Геннадьевич – Федералдық монополияға қарсы қызмет басшысының орынбасары

ШАТАЛОВ Сергей Дмитриевич – Ресей Федерациясы Қаржы министрінің орынбасары

ШЕСТАКОВ Илья Васильевич – Ресей Федерациясы Ауыл шаруашылығы министрінің орынбасары – Федералдық балық аулау агенттігінің басшысы

ЯНОВСКИЙ Анатолий Борисович – Ресей Федерациясы Энергетика министрінің орынбасары



Еуразиялық экономикалық комиссиядан



АКБЕРДИН Рустам Александрович – Экономика және қаржы саясаты жөніндегі алқа мүшесінің (Министрдің) көмекшісі

АРНАУТОВ Олег Вячеславович – Санитариялық, фитосанитариялық және ветеринариялық шаралар департаментінің директоры

БОЙЦОВ Василий Борисович – Техникалық реттеу және аккредиттеу департаментінің директоры

БОРЦОВ Олег Васильевич – Кедендік ынтымақтастық жөніндегі алқа мүшесі (Министр) Хатшылығының басшысы

ТАНЕЕВА Марина Вилевна – Қаржы департаментінің директоры

ГУДИН Виталий Васильевич – Кедендік-тарифтік және тарифтік емес реттеу департаментінің директоры

ЕГОРОВ Сергей Васильевич – Істерді басқару департаментінің директоры

ЕРМАКАЛИЕВА Лариса Сериковна – Бәсекелестік және монополияға қарсы реттеу жөніндегі алқа мүшесі (Министр) Хатшылығының басшысы

ЗАЙЧЕНКО Николай Петрович – Өнеркәсіп және агроөнеркәсіптік кешен жөніндегі алқа (Министр) мүшесі Хатшылығының басшысы

ИЛЬИН Виталий Григорьевич – Интеграция мен макроэкономиканың негізгі бағыттары жөніндегі алқа мүшесі (Министр) Хатшылығының басшысы

ИЛЬИЧЕВ Владимир Евгеньевич – Ішкі нарықты қорғау департаментінің директоры

КІШКЕМБАЕВ Асқар Болатұлы – Экономика және қаржы саясаты жөніндегі алқа мүшесі (Министр) Хатшылығының басшысы

КУРИЛЬЧИК Александр Федорович – Монополияға қарсы реттеу департаменті директорының орынбасары

МАЛЬЦЕВ Владимир Валерьевич – Өнеркәсіптік саясат департаментінің директоры

МЯСНИК Виктор Чеславович – Энергетика департаментінің директоры

НЕКРАСОВ Дмитрий Викторович – Кеден заңнамасы және құқық қолдану практикасы департаментінің директоры

НҰРАХМЕТОВ Ержан Сағымбайұлы – Көлік және инфрақұрылым департаментінің директоры

РИС Алексей Владимирович – Хаттама және ұйымдастырушылық қамтамасыз ету департаментінің директоры

СКИБА Владимир Юрьевич – Кедендік инфрақұрылым департаментінің директоры

СКОКОВ Александр Николаевич – Алқа Төрағасы Хатшылығының басшысы

СПАССКИЙ Виктор Валентинович – Интеграцияны дамыту департаментінің директоры

ТАРАСКИН Владимир Иванович – Құқықтық департамент директоры

ТОЧИН Андрей Владимирович – Сауда саясаты департаментінің директоры

ФАЗЫЛ Алмат Үйсінұлы – Монополияға қарсы реттеу департаментінің директоры

ХОТУЛҢВ Евгений Леонидович – Макроэкономикалық саясат департаментінің директоры

ХОТЬКО Александр Николаевич – Ақпараттық технологиялар департаментінің директоры

ХУЛХАЧИЕВ Бембю Викторович – Қаржы саясаты департаментінің директоры

ЦЫДЫПОВ Баясхалан Дарижапович – Сауда жөніндегі алқа мүшесі (Министр) Хатшылығының басшысы

ЧЕГЛИК Людмила Владимировна – Өнеркәсіп және агроөнеркәсіптік кешен жөніндегі алқа мүшесінің (Министрдің) көмекшісі

ЧУЙКО Михаил Георгиевич – Техникалық реттеу мәселелері жөніндегі алқа мүшесі (Министр) Хатшылығының басшысы

ШОКАМАНОВ Юрий Камирович – Статистика департаментінің директоры

ШӨБЕКОВ Болат Қасымбекұлы – Энергетика және инфрақұрылым жөніндегі алқа мүшесі (Министр) Хатшылығының басшысы



III дәрежелі медалімен:

Беларусь Республикасынан



АЛЕКСАНДРОВИЧ Александр Александрович – Беларусь Республикасының Оңтүстік Африка Республикасындағы Елшілігінің кеңесші-елшісі

АНИКОВИЧ Елена Борисовна – Жеңіл өнеркәсіп тауарларын шығару және өткізу жөніндегі Белорус мемлекеттік концерні сыртқы экономикалық байланыстар басқармасы ТМД, ЕО елдерімен ынтымақтастық және көрме қызметі секторының басшысы

АНОШЕНКО Константин Борисович – Беларусь Республикасы Энергетика министрлігі Бас экономикалық басқармасының экономикалық талдау және болжау басқармасының бастығы

БАГРОВЕЦ Наталья Васильевна – "Белэнерго" мемлекеттік өндірістік электр энергетикасы бірлестігі электр энергиясының көтерме саудасы мен беру және қуаттылық басқармасының бастығы

БАЛТРУКОВИЧ Петр Иванович – Беларусь Республикасы Мемлекеттік ғылым және технологиялар комитеті Төрағасының орынбасары

БАРКОВСКАЯ Елена Эдуардовна – Беларусь Республикасы Байланыс және ақпараттандыру министрлігі пошта байланысы істері бөлімі бастығының орынбасары

БАСАЛЫГА Александр Евгеньевич - Беларусь Республикасы Әділет министрлігі Халықаралық ынтымақтастық басқармасының халықаралық-құқықтық бөлім бастығы

БЕЛОВ Олег Александрович – Беларусь Республикасының Болгария Республикасындағы Елшілігінің кеңесшісі

БОГДАНКЕВИЧ Ольга Анатольевна – Беларусь Республикасы Экономика министрлігі Сыртқы экономикалық саясат бас басқармасы экономикалық интеграция басқармасының бас экономисі

БОРСУК Сергей Георгиевич – Беларусь Республикасы Мемлекеттік қауіпсіздік комитеті Бас қауіпсіздік басқармасы бөлімінің аға референті

БОРУШКО Игорь Георгиевич – Беларусь Республикасы Өнеркәсіп министрлігі Машина жасау басқармасының бастығы

БРОВКИН Петр Николаевич – "Ұлттық зияткерлік меншік орталығы" мемлекеттік мекемесінің бас директоры

БУРДЫКО Владимир Михайлович – "Белорус машина сынау станциясы" директорының сертификаттау жөніндегі орынбасары, ауыл шаруашылығы техникасы мен тракторларды сертификаттау органы басшысының орынбасары, ауыл шаруашылығы техникасы мен тракторларды сертификаттау бөлімінің меңгерушісі

ВАВОХИНА Екатерина Викторовна – Беларусь Республикасы Мемлекеттік кеден комитеті Кедендік бақылауды ұйымдастыру басқармасы тыйым салулар мен шектеулердің сақталуын бақылауды ұйымдастыру бөлімінің бас инспекторы

ВИТЯЗЬ Петр Александрович – Беларусь Ұлттық ғылым академиясы аппаратының басшысы

ГАЙКО Сергей Петрович – Беларусь Республикасы Ұлттық банкі қолма-қол ақша айналысы бас басқармасының бастығы

ГАНАКОВА Елена Викторовна – Беларусь Республикасы Экономика министрлігі Баға саясаты департаменті монополистік қызметке қарсы іс-қимыл және даму бөлімінің бастығы

ГОРЕЛИК Дмитрий Николаевич – Беларусь Республикасы Министрлері Кеңесі Аппараты халықаралық ынтымақтастық және сауда бас басқармасының бастығы

ДОЛГИХ Галина Ивановна – "Белэнерго" мемлекеттік өндірістік электр энергетикасы бірлестігінің сыртқы экономикалық ынтымақтастық басқармасы бастығының орынбасары

ДРОЗДОВА Татьяна Михайловна – Беларусь Республикасы Экономика министрлігі Отын-энергетикалық кешен, химия және фармацевтикалық өнеркәсіп бас басқармасының бастығы

ДУБИНИЧ Наталья Лазаревна – Беларусь Республикасы Экономика министрлігі Сыртқы экономикалық саясат бас басқармасы экономикалық интеграция басқармасының бас экономисі

ЕВДОЧЕНКО Андрей Александрович – Беларусь Республикасының Бельгия Корольдігіндегі Төтенше және Өкілетті Елшісі, Беларусь Республикасының Ұлы Люксембург Герцогтігіндегі Төтенше және Өкілетті Елшісі, Беларусь Республикасының Еуропалық Одақтағы және Еуропалық атом энергиясы жөніндегі қоғамдастықтағы Тұрақты өкілі, Беларусь Республикасының Солтүстік Атлант шарты ұйымы жанындағы Тұрақты өкілі (қоса атқару бойынша)

ЖОЛНЕРОВИЧ Зинаида Михайловна – Беларусь Республикасы Ауыл шаруашылығы және азық-түлік министрлігі Білім, ғылым және кадр бас басқармасы ғылым бөлімінің бастығы

ЗАЛОМАЙ Игорь Владимирович – Беларусь Республикасы Сыртқы істер министрлігі ТМД елдерімен екіжақты қатынастар басқармасы Украина, Молдова және Закавказье бөлімінің бастығы

ЗОРИЧ Андрей Михайлович – Беларусь Республикасы Энергетика министрлігі Стратегиялық даму және сыртқы инвестициялық ынтымақтастық басқармасының бастығы

ЗУБКОВ Владимир Анатольевич – Беларусь Республикасы Мемлекеттік қауіпсіздік комитеті Қауіпсіздік бас басқармасының бас референті

ИВАНОВ Юрий Евгеньевич – Беларусь Республикасы Экономика министрлігі Өнеркәсіп, көлік және байланыс бас басқармасы Тұтыну тауарлары экономикасы бөлімінің бастығының

ИВЛЕВ Сергей Антонович – Беларусь Республикасы Мемлекеттік стандарттау комитеті төрағасының орынбасары

ИНЬШИН Павел Михайлович – Беларусь Республикасы Ұлттық банкі Сыртқы экономикалық қызмет бас басқармасы интеграциялық ынтымақтастық басқармасының бастығы

КАЖУРО Михаил Викторович – Беларусь Республикасы Сыртқы істер министрлігі Еуразиялық интеграция басқармасы өңірлік интеграция бөлімінің бастығы

КАНАШ Игорь Игоревич – Беларусь Республикасы Байланыс және ақпараттандыру министрлігі ақпараттандыру департаменті ақпараттандыру бағдарламалары мен жобалары бөлімі бастығының орынбасары

КАРПОВИЧ Станислав Константинович – Беларусь Республикасы Ауыл шаруашылығы және азық-түлік министрлігі Машиналар мен жабдықтың техникалық жай-күйін қадағалау жөніндегі бас мемлекеттік инспекциямен бірге Техникалық прогресс және энергетика бас басқармасының бастығы

КАТЕРИНИЧ Дмитрий Степанович – "Минск автомобиль зауыты" ашық кционерлік қоғамының бас директоры – "БЕЛАВТОМАЗ" холдингі компаниясының басқарушысы

КОЗЛОВСКАЯ Татьяна Геннадьевна – Беларусь Республикасы Әділет министрлігі Халықаралық ынтымақтастық басқармасының халықаралық-құқықтық бөлімі бастығының орынбасары

КОМАР Юрий Адамович – Беларусь Республикасы Экономика министрлігі Сыртқы экономикалық саясат бас басқармасының сыртқы саясатты болжау басқармасы бастығының орынбасары

КОМИК Виталия Сергеевна – Беларусь Республикасы Мемлекеттік ғылым және технологиялар комитеті заң бөлімінің бастығы

КОРЗЮК Юрий Иосифович – Беларусь Республикасы Министрлер Кеңесі Аппараты халықаралық ынтымақтастық және сауда Бас басқармасының интеграциялық бірлестіктермен жұмыс бөлімінің бас кеңесшісі

КОРОЛЮК Василий Федорович – Беларусь Республикасы Мемлекеттік стандарттау комитеті Сәйкестікті бағалау және лицензиялау басқармасының бастығы

КРАВЦОВА Инесса Викторовна – Беларусь Республикасы Ұлттық банкі валюталық реттеу және валюталық бақылау бас басқармасы валюталық реттеу басқармасының бастығы

КУДРЯШОВ Александр Николаевич – Беларусь Республикасы Төтенше жағдайлар министрлігі Өнеркәсіпте жұмыстардың қауіпсіз жүргізілуін қадағалау департаментінің бастығы

ЛАВРУЩИК Андрей Васильевич – Беларусь Республикасы Ұлттық банкі сыртқы экономикалық қызмет бас басқармасының интеграциялық ынтымақтастық басқармасы бастығының орынбасары

ЛАГУТЕНКО Людмила Дмитриевна – Беларусь Республикасы Салықтар және алымдар министрлігі Ақпараттық технологиялар бас басқармасының бастығы

ЛЕСНОЙ Алексей Вячеславович – Беларусь Республикасы Ұлттық банкі сыртқы экономикалық қызмет бас басқармасының бастығы

ЛИПНИЦКИЙ Юрий Альбинович – Беларусь Республикасы Ұлттық банкі Банктік қадағалау бас басқармасы бастығының орынбасары

ЛОМАКИНА Алла Леоновна – Беларусь Республикасы Ауыл шаруашылығы және азық-түлік министрлігі экономика бас басқармасының бастығы

МАТУЛИС Эдвард Брониславович – Беларусь Республикасы Сауда министрінің орынбасары

МАЦЕВИЛО Алексей Евгеньевич – Беларусь Республикасы Экономика министрлігі Сыртқы экономикалық саясат бас басқармасы бастығының орынбасары - экономикалық интеграция басқармасының бастығы

МАЦКЕВИЧ Олег Сергеевич – Витебск облыстық атқару комитеті төрағасының орынбасары

МЕДВЕДЕВ Геннадий Викторович – Беларусь Республикасы Министрлер Кеңесі Аппараты Халықаралық ынтымақтастық және сауда бас басқармасы бастығының орынбасары - сыртқы және ішкі сауда басқармасының бастығы

МЕРКУЛОВ Владимир Сергеевич – "Белорус мемлекеттік стандарттау және сертификаттау институты" ғылыми-өндірістік республикалық унитарлық кәсіпорны бөлімінің бастығы

МИНИЧ Дина Николаевна – Беларусь Республикасы Қаржы министрлігі Халықаралық қаржылық қатынастар бас басқармасы экономикалық интеграцияны дамыту бөлімінің консультанты

МИСЮРОВ Сергей Петрович – Одақтас мемлекет Тұрақты Комитеті Минск қаласындағы Өкілдігі басшысының орынбасары

МОКРЯГИН Александр Олегович – Беларусь Республикасы Байланыс және ақпараттандыру министрлігі сыртқы байланыс бөлімінің бастығы

МОЛОШ Юлия Викторовна – Беларусь Республикасы Экономика министрлігі Сыртқы экономикалық саясат бас басқармасы экономикалық интеграция басқармасының консультанты

МОРОЗ Сергей Александрович – Беларусь Республикасы Ұлттық банкі Сыртқы экономикалық қызмет бас басқармасы интеграциялық ынтымақтастық басқармасының бас маманы

МУКВИЧ Владимир Валерьевич – Беларусь Республикасы Салықтар және алымдар министрлігі Акцизделетін тауарларды, ойын бизнесін және тауарларды өткізуді бақылаудың электрондық жүйелерін бақылау бас басқармасының бастығы

МУРАШКО Наталия Анатольевна – Жеңіл өнеркәсіп тауарларын шығару және өткізу жөніндегі Белорус мемлекеттік концерні сыртқы экономикалық байланыстар басқармасы бастығының орынбасары

НЕХАЙЧИК Андрей Викторович – Беларусь Республикасының Ресей Федерациясындағы Елшілігінің бірінші хатшысы

НИКУЛИНА Светлана Леонидовна – Беларусь Республикасы Министрлер Кеңесі Аппараты Халықаралық ынтымақтастық және сауда бас басқармасы халықаралық ынтымақтастық басқармасының бас кеңесшісі

ОРДА Елена Валерьевна – Беларусь Республикасы Ұлттық банкі бас заң басқармасы заң жобалау жұмыстары және нормативтік құқықтық актілер сараптамасы басқармасының бастығы

ОСЕНКО Сергей Александрович – Беларусь Республикасы Қаржы министрлігі Сақтандыру қадағалауы бас басқармасының бастығы

ПАНАСЮК Сергей Константинович – Беларусь Республикасы Сыртқы істер министрлігі Еуразиялық интеграция басқармасы өңірлік интеграция бөлімінің аға кеңесшісі

ПАНТЮХОВ Владимир Иванович – Беларусь Республикасы Экономика, бюджет және қаржы жөніндегі Ұлттық жиналыстың Республика Кеңесі Тұрақты комиссиясының Төрағасы

ПАНФЕРОВ Алексей Викторович – Беларусь Республикасының Француз Республикасындағы Өкілдігінің кеңесшісі

ПЕТРОВИЧ Ирина Петровна – Беларусь Республикасы Экономика министрлігі Сыртқы экономикалық саясат бас басқармасы экономикалық интеграция басқармасының консультанты

ПЛЕШКО Владимир Леонидович – "Тұқым шаруашылығы, өсімдіктер карантині және қорғау жөніндегі Бас мемлекеттік инспекциясы" мемлекеттік мекемесінің директоры – Беларусь Республикасының тұқым шаруашылығы, өсімдіктер карантині және қорғау жөніндегі мемлекеттік бас инспекторы

ПРОХНИЧ Юрий Прокофьевич – Беларусь Республикасы Төтенше жағдайлар министрлігі Өнеркәсіпте жұмыстарды қауіпсіз жүргізуді қадағалау департаменті қысыммен жұмыс істейтін жабдықтың және жылу электр станцияларының қауіпсіздігін қадағалау басқармасының бастығы

РАФАЛЬСКИЙ Владимир Николаевич – Беларусь Республикасы Төтенше жағдайлар министрлігі Қадағалау және профилактика басқармасының бастығы

РОМАНОВИЧ Александр Семенович – "Тұқым шаруашылығы, өсімдіктер карантині және қорғау жөніндегі Бас мемлекеттік инспекциясы" мемлекеттік мекемесі директорының орынбасары – өсімдіктер карантині жөніндегі мемлекеттік инспекция бастығы – Беларусь Республикасының тұқым шаруашылығы, өсімдіктер карантині және қорғау жөніндегі мемлекеттік бас инспекторы

РОМАНОВСКИЙ Алексей Валерьевич – Беларусь Республикасы Экономика министрлігі Сыртқы экономикалық саясат бас басқармасы экономикалық интеграция басқармасы бастығының орынбасары

РЫЖКОВСКИЙ Леонид Владимирович – Беларусь Республикасы Өнеркәсіп министрлігі Электр техникасы, оптикалық-механикалық өнеркәсібі және аспап жасау басқармасының бастығы

САДОВНИКОВ Юрий Иванович – Беларусь Республикасы Төтенше жағдайлар министрлігі Өнеркәсіпте жұмыстарды қауіпсіз жүргізуді қадағалау департаменті лицензиялау, сертификаттау, оқытуды ұйымдастыру және рұқсат беру жұмысы басқармасының бастығы

САКУН Валерия Николаевна – Беларусь Республикасы Энергетика министрлігі Стратегиялық даму және сыртқы инвестициялық ынтымақтастық басқармасы бастығының орынбасары

САМОСУЕВ Алексей Иванович – Беларусь Республикасы Сыртқы істер министрлігі Еуразиялық интеграция басқармасының бастығы

САССА Вячеслав Николаевич – Беларусь Республикасы Энергетика министрлігі Сыртқы экономикалық саясат және халықаралық ынтымақтастық бөлімі бастығының орынбасары

СКОРИНА Людмила Мефодьевна – "Белорус мемлекеттік стандарттау және сертификаттау институты" республикалық унитарлық кәсіпорны ғылыми-өндірістік бөлімінің бастығы

СПРЕСОВ Дмитрий Васильевич – Беларусь Республикасы Сыртқы істер министрлігі Шарттық-құқықтық бас басқармасы бастығының орынбасары

СТЕПАНЕНКО Василий Алексеевич – Беларусь Республикасы Төтенше жағдайлар министрінің бірінші орынбасары

СУШКО Сергей Александрович – Беларусь Республикасы Қаржы министрлігі Бағалы қағаздар департаментінің директоры

ТОКУН Олег Валерьевич – Беларусь Республикасы Еңбек және әлеуметтік қорғау министрлігі Жұмыспен қамту саясаты басқармасының бастығы

ТРЕПЕНОК Иван Сергеевич – Беларусь Республикасы Экономика министрлігі Баға саясаты департаменті директорының орынбасары

ТУРОВЕЦ Татьяна Игоревна – Беларусь Республикасы Министрлер Кеңесі Аппараты Халықаралық ынтымақтастық және сауда бас басқармасы бастығының орынбасары – халықаралық ынтымақтастық басқармасының бастығы

ТУСКАЛЬ Дмитрий Валерьевич – Беларусь Республикасы Әділет министрлігі Халықаралық ынтымақтастық басқармасы Халықаралық шарттарды орындау бөлімінің бас маманы

ФАЛЕЙ Тамара Ивановна – Беларусь Республикасы Салықтар және алымдар министрлігі халықаралық салықтық ынтымақтастық басқармасы бастығының орынбасары

ФАЛЬКОВА Наталья Вячеславовна – Беларусь Республикасы Байланыс және ақпараттандыру министрлігі Сыртқы байланыстар бөлімінің консультанты

ФЕДОРЕЕВА Ольга Николаевна – Беларусь Республикасы Байланыс және ақпараттандыру министрлігі электр байланысы басқармасы бастығының орынбасары - даму стратегиясы бөлімінің бастығы

ХАРИТОНЧИК Дмитрий Иванович – Беларусь Республикасы Өнеркәсіп, отын-энергетикалық кешен, көлік және байланыс жөніндегі Ұлттық жиналысы Өкілдері Палатасы Тұрақты комиссиясының Төрағасы

ХАТКЕВИЧ Елена Николаевна – Беларусь Республикасы Экономика министрлігі Сыртқы экономикалық саясат бас басқармасы экономикалық интеграция басқармасының консультанты

ЧАУСОВ Виктор Николаевич – "Белорус стандарттау және сертификаттау мемлекеттік институты" республикалық унитарлық кәсіпорны ғылыми-өндірістік бөлімінің бастығы

ЧАЩИН Михаил Юрьевич – Беларусь Республикасы Байланыс және ақпараттандыру министрлігі Ақпараттандыру департаментінің директоры

ЧЕБОТАРЬ Юрий Адамович – Беларусь Республикасы Экономика министрлігі Өнеркәсіп, көлік және байланыс бас басқармасының бастығы

ШАТОХИН Екатерина Владимировна – Беларусь Республикасы Мемлекеттік кеден комитеті Кедендік бақылауды ұйымдастыру бас басқармасы кедендік декларациялауды және тауарларды шығаруды ұйымдастыру бөлімінің инспекторы

ШИХ Виктор Адамович – Беларусь Республикасының Австралия Одағындағы Төтенше және Өкілетті Елшісі

ШПАК Александр Петрович – "Беларусь Ұлттық ғылым академиясының АӨК жүйелі зерттеулер институты" республикалық ғылыми унитарлық кәсіпорнының директоры

ШУЛЬГА Павел Пантелеевич – Беларусь Республикасы Қаржы министрлігі Халықаралық қаржылық қатынастар Бас басқармасының бастығы

ШУРПАК Анна Ивановна – Беларусь Республикасы Экономика министрлігі Макроэкономикалық талдау және болжау бас басқармасы макроэкономикалық саясат бөлімінің консультанты

ЮДО Ирина Валентиновна – Беларусь Республикасы Әділет министрлігі Халықаралық ынтымақтастық басқармасы халықаралық-құқықтық бөлімінің бас маманы

ЮХИМУК Михаил Иванович – Брест облыстық атқару комитеті Төрағасының бірінші орынбасары



Қазақстан Республикасынан



АБАЙДЕЛДИНОВ Ербол Мұсаұлы – "Қазақстан Республикасы Заңнама институты" мемлекеттік мекемесінің бас ғылыми қызметкері

ӘБДІРАХМАНОВ Нұрлан Алмасұлы – Қазақстан Республикасы Ұлттық Банкі Бақылау және қадағалау әдіснамасы департаментінің директоры

ӘБДРЕЕВА Шолпан Тоқтарқызы – Қазақстан Республикасы Әділет министрлігі Зияткерлік меншік істері департаменті директорының орынбасары

ӘБДУӘЛИЕВА Меруерт Құлмұратқызы – Қазақстан Республикасы Ұлттық экономика министрлігі Халықаралық экономикалық интеграция департаменті директорының орынбасары

АБДУЛЛИН Арман Мақсұтұлы – Қазақстан Республикасы Ауыл шаруашылығы министрлігі Агроөнеркәсіптік кешендегі мемлекеттік инспекция комитеті Өсімдіктер карантині жөніндегі мемлекеттік инспекция басқармасының басшысы

ӘБІЛҒАЗЫ Талғат Әбілғазыұлы – Қазақстан Республикасы Энергетика министрлігі Электр энергетикасы департаменті директорының орынбасары

ӘБІШЕВА Руза Аманкелдіқызы – Қазақстан Республикасы Қаржы министрлігі Халықаралық қаржылық қатынастар департаменті директорының орынбасары

АБСАТОВ Ерлан Сембекұлы – Қазақстан Республикасы Инвестициялар және даму министрлігі Экономикалық интеграция департаменті директорының орынбасары

АЗЕНОВ Жаслан Ерікұлы – Қазақстан Республикасы Ұлттық экономика министрлігі Сыртқы сауда қызметін дамыту департаменті сыртқы сауда келіссөздері басқармасының жетекшісі

АЙТАЕВ Ренат Құрметжанұлы – Қазақстан Республикасы Премьер-Министрі Кеңсесі индустриялық-инновациялық даму бөлімінің меңгерушісі

АЙТБАЕВА Нұргүл Талғатқызы – "Сауда саясатын дамыту орталығы" акционерлік қоғамы Дүниежүзілік сауда ұйымы келісімдер департаменті директорының орынбасары

АЙТҚОЖИН Темірлан Болатқанұлы – Қазақстан Республикасы Премьер-Министрі Кеңсесі сыртқы байланыстар және хаттама бөлімінің бас сарапшысы

ӘЛІМБЕТОВА Әлия Назымбекқызы – Қазақстан Республикасы Ұлттық экономика министрлігі Сыртқы сауда қызметі департаменті директорының орынбасары

АМРИН Азамат Кемеңгерұлы – Қазақстан Республикасы Ұлттық экономика министрлігі Салық және кедендік саясат департаментінің директоры

АМРИН Ғұсман Кәрімұлы – Қазақстан Республикасы Қаржы министрлігі Мемлекеттік кірістер комитеті Төрағасының орынбасары

АРТЫҚОВА Айдын Қыдырбайқызы – Қазақстан Республикасы Әділет министрлігі Зияткерлік меншік комитеті "Ұлттық зияткерлік меншік институты" республикалық мемлекеттік кәсіпорнының құқық және халықаралық шарттар басқармасының бастығы

АСАУТАЕВ Бахтияр Берікұлы – Қазақстан Республикасы Ұлттық экономика министрлігі Халықаралық экономикалық интеграция департаментінің Бірыңғай экономикалық кеңістік құру мәселелері жөніндегі басқарманың бас сарапшысы

АСҚАРОВА Найля Жанаберліқызы – Қазақстан Республикасы Қаржы министрлігі Мемлекеттік қарыз алу департаменті басқармасының басшысы

АХМЕТОВА Алтын Қалидолақызы – Қазақстан Республикасы Қаржы министрлігі Мемлекеттік кірістер комитеті Халықаралық ынтымақтастық басқармасының бас сарапшысы

АХМЕТОВА Зауре Дәлелқызы – Қазақстан Республикасы Ұлттық экономика министрлігі Тұтынушылардың құқықтарын қорғау комитеті Зертханалық қызмет басқармасының басшысы

АШЕНОВА Алмагүл Ибрагимқызы – Қазақстан Республикасы Әділет министрлігі Зияткерлік меншік құқығы комитеті "Ұлттық зияткерлік меншік институты" республикалық мемлекеттік кәсіпорнының ақпараттандыру және ақпараттық ресурстар басқармасының бастығы

БАЙБАҒЫСОВА Айсұлу Сапиқызы – Қазақстан Республикасы Ұлттық Банкінің Ресей Федерациясындағы Өкілдігінің Басшысы

БАЙБАТЧИН Еркін Әубәкірұлы – Қазақстан Республикасы Ішкі істер министрлігі Көші-қон полициясы департаменті бастығының орынбасары

БАЙҒОЖИНА Айгүл Мұрзатайқызы – Қазақстан Республикасы Қаржы министрлігі Қазынашылық комитеті төрағасының орынбасары

БАЙҚАДАМОВА Уасиля Төлеуқызы – Қазақстан Республикасы Ұлттық экономика министрлігі Сыртқы сауда қызметін дамыту департаменті директорының орынбасары

БӘРІКЕНОВ Аман Сайлаубекұлы – Қазақстан Республикасы Премьер-Министрі Кеңсесі Әлеуметтік-экономикалық бөлімінің бас консультанты

БАТЫРХАНОВ Ерік Романұлы – Қазақстан Республикасы Ұлттық кәсіпкерлер палатасы экономикалық интеграция департаментінің I санаттағы сарапшысы

БЕКБОСЫНОВА Сәния Өтебекқызы – Қазақстан Республикасы Ұлттық экономика министрлігі Сыртқы сауда қызметін дамыту департаменті сыртқы сауда келіссөздері басқармасының бас сарапшысы

БЕКЕНОВА Бибигүл Темірғалиқызы – Қазақстан Республикасы Ауыл шаруашылығы министрлігі Ветеринариялық және тамақ қауіпсіздігі департаментінің директоры

БИСЕМБАЕВА Арайлым Айбекқызы – Қазақстан Республикасы Ұлттық экономика министрлігі сыртқы сауда қызметін дамыту департаменті қорғау шараларын қолдану басқармасының бас сарапшысы

БӨКЕБАЕВ Қазбек Төлегенұлы – Қазақстан Республикасы Сыртқы істер министрлігі Халықаралық-құқықтық департаментінің кеңесшісі

БОРАНБАЕВА Айгүл Мэлсқызы – Қазақстан Республикасы Ұлттық Банкі Төлем балансы, валюталық реттеу және статистика департаменті директорының орынбасары

ЖАМАНҚҰЛОВ Данияр Қалибекұлы – Қазақстан Республикасы Ұлттық экономика министрлігі Халықаралық экономикалық интеграция департаменті Бірыңғай экономикалық кеңістікті қалыптастыру мәселелері басқармасының сарапшысы

ЖАМАНҚҰЛОВ Рүстем Тұңғышбайұлы – Қазақстан Республикасы Сыртқы істер министрлігі Еуразиялық интеграция департаментінің кеңесшісі

ЖҰМАБАЕВА Әлия Маратқызы – Қазақстан Республикасы Ұлттық экономика министрлігі Табиғи монополияларды реттеу және бәсекелестікті қорғау комитеті төрағасының орынбасары

ЖҰМАШЕВ Ерлан Ермешұлы – Қазақстан Республикасы Инвестициялар және даму министрлігі Көлік комитеті төрағасының орынбасары

ДОҒАЛОВ Ғалымжан Тілектесұлы – Қазақстан Республикасы Инвестициялар және даму министрлігі Техникалық реттеу және метрология комитеті төрағасының орынбасары

ЕЛЕУСІЗОВ Айхын Қылышұлы – Қазақстан Республикасы Инвестициялар және даму министрлігі Экономикалық интеграция департаменті көлік және инфрақұрылым басқармасының жетекшісі

ЕЛЕУСІЗОВА Құралай Болатқызы – Қазақстан Республикасы Инвестициялар және даму министрлігі Байланыс, ақпараттандыру және ақпарат комитеті "Электрондық үкіметті" ішкі бақылау жобалары басқармасының басшысы

ЕЛІКБАЕВ Қуаныш Нұрланұлы – Қазақстан Республикасы Ұлттық экономика министрлігі Халықаралық экономикалық интеграция департаменті ЕурАзЭҚ пен Кеден одағының жұмыс істеу мәселелері басқармасының бас сарапшысы

ЕСПАЕВ Сағымбай Жолдығалиұлы – Қазақстан Республикасы Ұлттық экономика министрлігі Халықаралық экономикалық интеграция департаменті ЕурАзЭҚ пен Кеден одағының жұмыс істеу мәселелері басқармасының бас сарапшысы

ЖАҚСЫҒАЛИЕВА Венера Ернарқызы – Қазақстан Республикасы Әділет министрлігі экономикалық интеграция жөніндегі жобалар сараптамасы департаменті экономика, қаржы және және сауда саласындағы жобалар сараптамасы басқармасының басшысы

ЖАМБЫЛОВ Ержан Диасұлы – Қазақстан Республикасы Ұлттық экономика министрлігі Салықтық және кедендік саясат департаменті кедендік саясат басқармасының басшысы

ЖАНТАСОВ Темірлан Бекетұлы – Қазақстан Республикасы Ұлттық экономика министрлігі Халықаралық экономикалық интеграция департаменті Біртұтас экономикалық кеңістікті қалыптастыру мәселелері басқармасының басшысы

ЖҰМАБЕКОВ Хамит Сұлтанұлы – Қазақстан Республикасы Қаржы министрлігі Халықаралық қаржылық қатынастар департаментінің бас сарапшысы

ЖҰМАТАЕВА Шынар Жаңабайқызы – Қазақстан Республикасы Премьер-Министрі Кеңсесі Сыртқы байланыстар және хаттама бөлімінің бас сарапшысы

ЖҮНІСОВА Бахыт Абайқызы – Қазақстан Республикасы Қаржы министрлігі Мемлекеттік кірістер комитеті Дамыту және жаңғырту департаментінің басқарма басшысының орынбасары

ЖУСАНБАЕВ Еркін Семетайұлы – "Қазақстан темір жолы" ұлттық компаниясы" акционерлік қоғамының корпоративтік даму жөніндегі басқарушы директоры

ЗАБЕКОВ Азамат Төлешұлы – Қазақстан Республикасы Ауыл шаруашылығы министрлігі Ветеринариялық бақылау және қадағалау комитеті Ветеринариядағы интеграциялық өзара іс-қимыл Басқармасының бас сарапшысы

ЗЕКЕНОВА Айжан Жақсылыққызы – Қазақстан Республикасы Ұлттық экономика министрлігі Халықаралық экономикалық интеграция департаменті Біртұтас экономикалық кеңістікті қалыптастыру мәселелері басқармасының сарапшысы

ЫБРАЕВ Серік Нарсұлтанұлы – Қазақстан Республикасы Ауыл шаруашылығы министрлігі Стратегиялық жоспарлау және талдау департаментінің директоры

ЫБРАЙ Талғат Қарекеұлы – Қазақстан Республикасы Сыртқы істер министрлігі Еуразиялық интеграция департаменті директорының орынбасары

ИМАНБАЕВ Мұрат Серікұлы – Қазақстан Республикасы Ішкі істер министрлігі Әкімшілік полиция комитеті Мемлекеттік автомобиль инспекциясы басқармасы бөлімінің бастығы

ИСЕТОВ Арман Асқарұлы – Қазақстан Республикасы Сыртқы істер министрлігі Халықаралық-құқықтық департаментінің директоры

ИХСАНОВ Алмас Мұхитұлы – Қазақстан Республикасы Энергетика министрлігі Халықаралық ынтымақтастық және экономикалық интеграциялық процестер департаментінің бас сарапшысы

ҚАБАЗИЕВ Манарбек Шәкірұлы – Қазақстан Республикасы Сыртқы істер министрлігі ТМД департаменті директорының орынбасары

ҚАЖЫТАЕВА Нұргүл Серікқызы – Қазақстан Республикасы Сыртқы істер министрлігі Еуразиялық интеграция департаментінің бірінші хатшысы

ҚАЗАНТАЕВ Самат Мұратұлы – "Сауда саясатын дамыту орталығы" акционерлік қоғамы ішкі әкімшілік ету департаментінің директоры

ҚАПЫШЕВА Алтын-Ай Әмірғалиқызы – Қазақстан Республикасы Мемлекеттік қызмет істері және сыбайлас жемқорлыққа қарсы күрес агенттігі Мемлекеттік қызмет және сыбайлас жемқорлық профилактикасы департаменті тәртіптік-әкімшілік практика және мемлекеттік көрсетілетін қызметтер басқармасының бас сарапшысы

ҚАПЫШОВ Тілек Қанатұлы - Қазақстан Республикасы Сыртқы істер министрлігі Еуразиялық интеграция департаменті ЕО және БЭК басқармасының үшінші хатшысы

КӘРІМОВ Айдын Мейрамбекұлы – Қазақстан Республикасы Ұлттық экономика министрлігі Халықаралық экономикалық интеграция департаменті директорының орынбасары

КӘРІМОВА Эльвира Шағатайқызы – Қазақстан Республикасы Ұлттық кәсіпкерлер палатасы Кедендік әкімшілік ету департаменті директорының орынбасары

КАРПЛЮК Сергей Алексеевич – Қазақстан Республикасы Қостанай облысы әкімінің орынбасары

КЕНЖАЛИН Жандос Жұмабекұлы – Қазақстан Республикасы Ұлттық Банкі Халықаралық қатынастар және жұршылықпен байланыс департаментінің халықаралық ынтымақтастық басқармасы бастығының орынбасары

ҚИЛЫБАЕВ Алтынбек Сенбайұлы – Қазақстан Республикасы Қаржы министрлігі Мемлекеттік кірістер комитеті Кедендік ресімдеу департаментінің бас сарапшысы

ҚЫПШАҚОВ Арғын Мықтыбайұлы – Қазақстан Республикасы Қаржы министрлігі Мемлекеттік кірістер комитеті төрағасының орынбасары

ҚОЖАХМЕТОВА Зәйтүн Аркенқызы – Қазақстан Республикасының Өзбекстан Республикасындағы Елшілігінің кеңесшісі

ҚОЗЖАНОВА Майраш Сапарбекқызы – Қазақстан Республикасы Денсаулық сақтау және әлеуметтік даму министрлігі Әлеуметтік қамсыздандыру және әлеуметтік сақтандыру департаментінің директоры

КӨПЕЖАНОВА Нұржамал Әшірбекқызы – Қазақстан Республикасы Ішкі істер министрлігі Штаб-департаменті үйлестіру басқармасының бастығы

ҚҰБАШЕВ Әміржан Нұрланұлы – "Сауда саясатын дамыту орталығы" акционерлік қоғамының мониторинг жөніндегі кеңесшісі

ҚҰЛЖАБАЕВА Жанат Орынбекқызы – Қазақстан Республикасы Заңнама институты директорының заң шығару жұмысы жөніндегі орынбасары

ҚҰЛМУРЗИН Қуандық Сағындықұлы – Қазақстан Республикасы Энергетика министрлігі Мұнай өнеркәсібін дамыту департаментінің директоры

КҮПӘНОВА Ләззат Кәкешқызы – Қазақстан Республикасы Ауыл шаруашылығы министрлігі Өсімдік өнімін өндіру және өңдеу және фитосанитариялық қауіпсіздік департаменті директорының орынбасары

КУРБАТ Александр Леонидович – Қазақстан Республикасы Қаржы министрлігі Мемлекеттік кірістер комитеті Кедендік бақылау департаментінің бас сарапшысы

КУШУКОВА Жанель Сабырқызы – Қазақстан Республикасы Ұлттық экономика министрлігі Сыртқы сауда қызметін дамыту департаментінің директоры

ҚЫСЫҚОВ Асқар Бауыржанұлы – Қазақстан Республикасы Ұлттық кәсіпкерлер палатасы Экономикалық интеграция департаменті директорының орынбасары

МАДАЛИЕВ Бақытжан Нұрханұлы – Қазақстан Республикасы Ұлттық экономика министрлігі Қазақстан Республикасы Экономикалық интеграция істері министрінің кеңесшісі

МАЙҚОНОВА Мәриям Сабырқызы – Қазақстан Республикасы Ұлттық экономика министрлігі Макроэкономикалық талдау және болжау департаментінің экономикалық саясатты үйлестіру басқармасының бас сарапшысы

МАҚАНОВА Мәдина Мұхамеджанқызы – Қазақстан Республикасы Ұлттық экономика министрлігі Сыртқы сауда қызметін дамыту департаменті тарифтік емес реттеу басқармасының жетекшісі

МАМБЕТАЛИН Әлихан Есенғосұлы – Қазақстан Республикасы Ұлттық кәсіпкерлер палатасы Кедендік әкімшілік ету департаментінің директоры

МАРАТ Мадина – Қазақстан Республикасы Инвестициялар және даму министрлігі Индустриялық даму және өнеркәсіптік қауіпсіздік комитеті Салааралық үйлестіру басқармасының сарапшысы

МАРС Алмабек Марсұлы – Қазақстан Республикасы Ауыл шаруашылығы министрлігі Агроөнеркәсіптік кешендегі мемлекеттік инспекция комитеті төрағасының орынбасары

МЕДЕБАЕВА Әлия Балтабайқызы – Қазақстан Республикасы Ұлттық кәсіпкерлер палатасы Экономикалық интеграция департаментінің I санатты сарапшысы

МОЛДАХМЕТОВА Лейла Саятқызы – Қазақстан Республикасы Қаржы министрлігі Мемлекеттік кірістер комитеті Халықаралық ынтымақтастық басқармасының бас сарапшысы

МҰҚЫШЕВ Алмаз Қайырбекұлы – Қазақстан Республикасы Ұлттық экономика министрлігі Салық және кедендік саясат департаменті кедендік саясат басқармасының бас сарапшысы

МУСИНА Алтын Шайкенқызы – Қазақстан Республикасы Денсаулық сақтау дәне әлеуметтік даму министрлігі Әлеуметтік қамсыздандыру және әлеуметтік сақтандыру департаменті базалық әлеуметтік қамсыздандыру басқармасының жетекшісі

МҰСРАЛИЕВ Ержан Тұрсынханұлы – Қазақстан Республикасы Сыртқы істер министрлігі Еуразиялық интеграция департаменті КО және БЭК басқармасының жетекшісі

МҰТАЛИЕВА Фарида Мәлікқызы – Қазақстан Республикасы Қаржы министрлігі Халықаралық қаржылық қатынастар департаментінің директоры

МҰХАНОВА Гүлнар Жанетқызы – Қазақстан Республикасы Денсаулық сақтау және әлеуметтік даму министрлігі Халықаралық ынтымақтастық және интеграция департаментінің директоры

НОКИНА Гүлнар Зәкірқызы – Қазақстан Республикасы Ауыл шаруашылығы министрлігі Ветеринарлық бақылау және қадағалау комитеті Тамақ өнімдері мен тасымалданатын объектілердің қауіпсіздігі басқармасының басшысы

НҰРӘЛИЕВ Ералы Манапұлы – Қазақстан Республикасы Қаржы министрлігі Мемлекеттік кірістер комитеті Кедендік бақылау департаментінің бас сарапшысы

НҰРАХМЕТ Біржан Серікұлы – Қазақстан Республикасы Ұлттық экономика министрлігі Қазақстан Республикасы Экономикалық интеграция істері министрінің кеңесшісі

НҰРБЕКОВА Гаухар Тұрсынбайқызы – Қазақстан Республикасы Ұлттық Банкі Құқықтық қамтамасыз ету департаментінің бас маманы – заңгер консультанты

НҰРТАЗИН Мирлан Мирболатұлы – Қазақстан Республикасы Инвестициялар және даму министрлігінің Экономикалық интеграция департаменті интеграциялық процестерді реттеу басқармасының басшысы

ОЛЖАБАЕВ Қанат Жеңсікбайұлы –  Қазақстан Республикасы Ұлттық экономика министрлігінің Сыртқы сауда саясатын дамыту департаменті кедендік-тарифтік реттеу басқармасының басшысы

ПАК Лариса Юн-Бойевна –   Қазақстан Республикасы Денсаулық сақтау және әлеуметтік-даму министрлігінің Алматы қаласы бойынша Медициналық және фармацевтикалық қызметті бақылау комитетінің Департамент басшысы

РАДАЕВ Сергей Юрьевич – Қазақстан Республикасы Ұлттық Кәсіпкерлер палатасы Техникалық реттеу департаментінің директоры

РАЗЗАРЕНОВ Александр Александрович – Қазақстан Республикасы Ауыл шаруашылығы министрілігі Ветеринариялық бақылау және қадағалау комитетінің Ветеринариядағы интеграциялық өзара іс-қимыл басқармасының бас сарапшысы

РАМАЗАНОВА Әсел Амангелдіқызы –  Қазақстан Республикасы Ауыл шаруашылығы министрлігінің Экономикалық интеграция және агроазық-түлік нарықтары департаменті тарифтік, тарифтік емес реттеу және мемлекеттік қолдау мәселелері бойынша интеграциялау басқармасының басшысы

РАҚЫМЖАНОВА Марал Тілеулесқызы – Қазақстан Республикасы Ұлттық экономика министрлігінің Тұтынушылардың құқықтарын қорғау комитеті Санитариялық-гигиеналық қадағалау басқармасының бас сарапшысы

РАХИМОВ Қуат Жеңісовұлы – Қазақстан Республикасы Қаржы министрлігінің Мемлекеттік кіріс комитеті Кедендік ресімдеу департаментінің басқарма басшысының орынбасары

РАХМЕТОВ Дәурен Нұржановұлы – Қазақстан Республикасы Инвестициялар және даму министрлігінің Экономикалық интеграция департаменті Интеграциялық процестерді реттеу басқармасының сарапшысы

РАХМЕТОВА Мүслим Көмекқызы – Қазақстан Республикасы Қаржы министрлігі Есептілік және мемлекеттік қаржы-қаражат департаментінің басқарма басшысы

РЫМЖАНОВ Қазбек Тілеубекұлы – Қазақстан Республикасы Премьер-Министрі орынбасарының көмекшісі

РЫСПАЕВА Әлия Мұратбекқызы – Қазақстан Республикасы Сыртқы істер министрлігі Еуразиялық интеграция департаментінің бірінші хатшысы

САВЕЛЬЕВА Ксения Владимировна – Қазақстан Республикасы Ұлттық экономика министрлігінің Салық және кеден саясаты департаменті Кеден саясаты басқармасының бас сарапшысы

САГИДАН Анар Жарылкасынкызы – Қазақстан Республикасы Заңнама институты Халықаралық заңнама және салыстырмалы құқықтану бөлімінің бас сарапшысы - бастығы

САДУАҚАСОВ Нұрқан Олжабайұлы –  Қазақстан Республикасы Ұлттық экономика министрлігінің Тұтынушылардың құқықтарын қорғау комитеті Техникалық регламенттер талаптары мен санитариялық шаралардың сақталуын бақылау басқармасының басшысы

САЙЫНОВ Серік Сайынұлы – Қазақстан Республикасы Ішкі істер министрілігі Көші-қон полициясы департаментінің бастығы

САПАРҒАЛИЕВ Талғат Болатұлы – Қазақстан Республикасы Премьер-Министрі Кеңсесінің Индустриялық-инновациялық даму бөлімі мемлекеттік реттеу секторының меңгерушісі

САРМАНОВ Бекжан Ерхалыұлы – Қазақстан Республикасы Ұлттық экономика министрлігінің Халықаралық экономикалық интеграция департаменті ЕурАзЭО және Кеден одағының жұмыс істеу мәселелері басқармасының сарапшысы

СӘРСЕКЕЕВ Қуаныш Мейірбекұлы –  Қазақстан Республикасы Энергетика министрлігінің Газ өнеркәсібін дамыту департаменті директорының орынбасары

СӘРСЕМБАЕВ Марат Алданғорұлы – "Болашақ" консалтингтік тобы" жауапкершілігі шектеулі серіктестіктің бас ғылыми қызметкері

СӘРСЕНОВ Бауыржан Нұрланұлы –  Қазақстан Республикасы Энергетика министрлігі Электр энергетикасы департаментінің директоры

СӘРСЕНОВ Мәди Серікұлы – Қазақстан Республикасы Ұлттық экономика министрлігі Сыртқы сауда қызметін дамыту департаментінің бас сарапшысы

САХИ Альдина Дүйсенқызы – "Сауда саясатын дамыту орталығы" акционерлік қоғамының көрсетілетін қызметтер және инвестициялар саласындағы заңнаманы талдау департаментінің директоры

САХИПОВА Нұрғайша ֊ – Қазақстан Республикасы Әділет министрлігінің Зияткерлік меншік құқықтары комитеті "Ұлттық зияткерлік меншік институты" республикалық мемлекеттік кәсіпорнының зияткерлік меншік объектілерін коммерцияландыруға жәрдемдесу басқармасының бастығы

СЕЙФУЛЛИНА Айгүл Анатольевна – Қазақстан Республикасы Ұлттық экономика министрлігінің Халықаралық экономикалық интеграция департаменті ЕурАзЭО және Кеден одағының жұмыс істеу мәселелері басқармасының бас сарапшысы

СЕРҒАЗИЕВ Таңатар Аманжолұлы – Қазақстан Республикасы Қаржы министрлігінің Мемлекеттік кіріс комитеті Кедендік ресімдеу департаментінің бас сарапшысы

СИРОТИНА Марина Николаевна – "Сауда саясатын дамыту орталығы" акционерлік қоғамының Дүиежүзілік сауда ұйымы департаментінің директоры

СМАҒҰЛОВА Ботагөз Балтайқызы –  Қазақстан Республикасы Денсаулық сақтау және әлеуметтік даму министрлігінің Медициналық және фармацевтикалық қызметті бақылау комитеті фармацевтикалық инспекторат басқармасының басшысы

СМАҒҰЛОВА Нұргүл Ілесқызы – Қазақстан Республикасының Жоғарғы Соты жанындағы Соттардың қызметін қамтамасыз ету департаментінің Халықаралық байланыстар және хаттама бөлімі меңгерушісінің орынбасары

СУКУРОВ Нұрболат Николаевич – Қазақстан Республикасы Ұлттық кәсіпкерлер палатасының Мәскеу қ. Еуразиялық экономикалық комиссиядағы Өкілдігінің директоры

СҰЛТАНӘЛІ Гүлмира Хамидоллакызы – Қазақстан Республикасы Сыртқы істер министрлігінің Еуразиялық интеграция департаменті ЕурАзЭО басқармасының басшысы

СҰЛТАНОВ Руслан Серікұлы – "Сауда саясатын дамыту орталығы" акционерлік қоғамының бас директоры

ТӘЖЕНОВ Асқар Дәулетханұлы – Қазақстан Республикасы Ішкі істер министрлігінің Әкімшілік полиция комитеті Мемлекеттік автомобиль инспекциясы басқармасының жол және техникалық инспекцияның айрықша тапсырмалар жөніндегі аға инспекторы

ТАНИЕВ Ержан Бақытұлы –  Қазақстан Республикасы Қаржы министрлігінің Мемлекеттік кіріс комитеті Тауар номенклатурасы, кедендік құн және тарифтік реттеу басқармасы басшысының орынбасары

ТЕҢЕЛБАЕВ Бауыржан - Қазақстан Республикасы Қаржы министрлігінің Мемлекеттік кіріс комитеті Жанама қаржы-қаражатты әкімшілендіру басқармасының бас сарапшысы

ТЕҢІЗБАЕВА Алтын – Қазақстан Республикасы Қаржы министрлігі Мемлекеттік қарыз беру департаменті директорының орынбасары

ТІЛЕГЕНОВ Динара Серікқызы – Қазақстан Республикасы Ұлттық экономика министрлігінің Сыртқы сауда қызметін дамыту департаменті кедендік-тарифтік реттеу басқармасының бас сарапшысы

ТІЛЕУЛИН Рауан Манатұлы  –  Қазақстан Республикасы Премьер-Министрінің Кеңсесі Сыртқы байланыс және хаттама бөлімінің меңгерушісі –  Қазақстан Республикасы Премьер-Министрі протоколының шефі

ТЫНЫМБЕРГЕНОВА Майра Қайратқызы – Қазақстан Республикасы Премьер-Министрі орынбасарының штаттан тыс кеңесшісі

ТОРТАЕВ Жамбыл Тұрсынұлы – Қазақстан Республикасы Қаржы министрлігінің Мемлекеттік кіріс комитеті Заң басқармасының бас сарапшысы

ТӨЛЕҒАЛИЕВА Ажар Ғинятоллақызы – Қазақстан Республикасы Денсаулық сақтау және әлеуметтік даму министрлігі Әлеуметтік көрсетілетін қызметтер департаментінің директоры

ТҰРАРБЕКОВ Дидар Аманжолқызы – Қазақстан Республикасы Энергетика министрлігі Мұнай өнеркәсібін дамыту департаментінің бас сарапшысы

ТҰРСҰНҚҰЛОВ Әлжан Сағындықұлы – Қазақстан Республикасы Премьер-Министрінің Кеңсесі Сыртқы байланыс және хаттама бөлімінің бас инспекторы

ТЫНЫБЕКОВ Болатбек Серікұлы – Қазақстан Республикасы Қаржы министрлігінің Мемлекеттік кіріс комитеті Кедендік ресімдеу департаментінің бас сарапшысы

ҮМБЕТОВ Ажар Сапарбекқызы –   Қазақстан Республикасы Ұлттық экономика министрлігінің Макроэкономикалық талдау және болжамдау департаменті экономикалық саясатты үйлестіру басқармасының басшысы

ҰМЫТБАЕВ Берік Алтайұлы – Қазақстан Республикасы Ұлттық кәсіпкерлер палатасының Мәскеу қ. Еуразиялық экономикалық комиссиядағы Өкілдігі директорының орынбасары

ҮСЕРҚҰЛОВА Жанна Теміржанқызы – Қазақстан Республикасы Премьер-Министрінің Кеңсесі Сыртқы байланыс және хаттама бөлімінің бас сарапшысы

ФЕРАФОНОВА Ирина Александровна – Қазақстан Республикасы Инвестициялар және даму министрлігі Техникалық реттеу және метрология комитетінің бас сарапшысы

ХАЖИДИНОВА Әсел Мамырбекқызы – Қазақстан Республикасы Әділет министрлігінің Экономикалық интеграция бойынша жобаларды сараптау департаментінің Өнеркәсіп, агроөнеркәсіптік кешен және техникалық реттеу саласындағы жобаларды сараптау басқармасының басшысы

ХАЙДАРОВА Нұргүл Дулатқызы – "Сауда саясатын дамыту орталығы" акционерлік қоғамының сауда-экономикалық ынтымақтастық жөніндегі кеңесшісі

ЧИГАМБАЕВ Дәуір Батырұлы – "Сауда саясатын дамыту орталығы" акционерлік қоғамының экономика жөніндегі кеңесшісі

ШҮЙІНШАЛИНА Гүлжазира Мырзабекқызы – Қазақстан Республикасы Қаржы министрлігінің Мемлекеттік кіріс комитеті Жанама салықтарды әкімшілендіру басқармасының бас сарапшысы



Ресей Федерациясынан



АБРАМОВ Алексей Владимирович – Техникалық реттеу және метрология жөніндегі федералдық агенттіктің басшысы

АБРАМОВ Олег Вячеславович – Ресей Федерациясы Үкіметі Төрағасының Бірінші орынбасарының көмекшісі

АВРУТИН Александр Игоревич – Ресей Федерациясы Экономикалық даму министрлігінің Реттеуші әсерді бағалау департаменті ауыл және орман шаруашылығы, тамақ өнеркәсібі, сауда және көрсетілетін қызметтер саласындағы реттеуші әсерді бағалау бөлімінің кеңесшісі

АЛЕКСАНДРОВ Роман Владимирович – Ресей Федерациясы Көлік министрлігі Халықаралық ынтымақтастық департаментінің директоры

АЛИХАНОВ Антон Андреевич – Ресей Федерациясы Сауда және өнеркәсіп министрлігінің Сыртқы сауда қызметін мемлекеттік реттеу департаменті директорының орынбасары

АНДРИЯШИНА Наталья Вадимовна – Тұтынушылардың құқықтарын қорғау және адамның саламаттылығы саласындағы қадағалау жөніндегі федералдық қызметтің Құқық басқармасының бастығы

АРИСТОВ Сергей Алексеевич – Ресей Федерациясы Көлік министрінің орынбасары

АРТАМОНОВ Олег Викторович – Федералдық көші-қон қызметі Сыртқы байланыс басқармасының бастығы

АСТАХОВ Владислав Владимирович – Тарифтер жөніндегі федералдық қызметтің Халықаралық ынтымақтастық және сыртқы байланысты дамыту басқармасы бастығының орынбасары

АФАНАСЬЕВ Александр Анатольевич – Ресей Федерациясы Үкіметі Төрағасының Бірінші орынбасарының көмекшісі

БАЛАГУЛ Татьяна Викторовна – Ветеринариялық және фитосанитариялық қадағалау жөніндегі федералдық қызметтің Ішкі ветеринариялық қадағалау басқармасы бастығының орынбасары

БЕЛОЗЕРОВ Олег Валентинович – Ресей Федерациясы Көлік министрінің орынбасары

БЕЛОЦЕРКОВСКАЯ Галина Викторовна – Федералдық салық қызметінің Стандарттар және халықаралық ынтымақтастық басқармасының халықаралық қызмет бөлімінің бастығы

БЛИНОВА Татьяна Викторовна – Ресей Федерациясы Еңбек және әлеуметтік қорғау министрінің орынбасары

БОКАРЕВ Андрей Андреевич – Ресей Федерациясы Қаржы министрлігі Халықаралық қаржылық қатынастар департаментінің директоры

БОРАДЗОВ Артур Русланович – Ресей Федерациясы Қаржы министрлігінің Әкімшілік департаменті директорының орынбасары

БРАГИНА Валентина Николаевна –  Тұтынушылардың құқықтарын қорғау және адамның саламаттылығы саласындағы қадағалау жөніндегі федералдық қызметтің Құқық басқармасының нормативтік-әдістемелік қамтамасыз ету бөлімі бастығының орынбасары

БРАТЧИКОВ Александр Сергеевич – Ресей Федерациясы Президентінің сыртқы саясат жөніндегі басқармасының департамент кеңесшісі

БУТРИН Дмитрий Николаевич – "Коммерсантъ" газеті бас редакторының орынбасары

ВЕРНЕР Андрей Владимирович – Ресей Федерациясы Үкіметі Төрағасының Бірінші орынбасарының көмекшісі

ВИНОГРАДОВ Михаил Владимирович – Ресей Федерациясы Әділет министрлігі Халықаралық құқық және ынтымақтастық департаменті директорының орынбасары

ВОЛЬВАЧ Дмитрий Валерьевич – Федералдық салық қызметі Стандарттар және халықаралық ынтымақтастық басқармасының бастығы

ГНИНЕНКО Максим Юрьевич – Ветеринариялық және фитосанитариялық қадағалау жөніндегі федералдық қызметтің Фитосанитариялық бақылау, тұқымдық бақылау және астық сапасы басқармасы бастығының орынбасары

ГОЛОМОЛЗИН Анатолий Николаевич – Федералдық монополияға қарсы қызмет басшысының орынбасары

ГОРЫНКИНА Ирина Александровна –  Ресей Федерациясы Экономикалық даму министрлігінің Кеден одағы органдарымен өзара іс-қимыл және ТМД елдерімен экономикалық ынтымақтастық департаменті ұлтүсті институттарды дамыту бөлімі бастығының орынбасары

ГРИНКЕВИЧ Егор Борисович – Ресей Федерациясы Энергетика министрлігі Электр энергетикасын дамыту департаменті директорының орынбасары

ГРИЩЕНКО Денис Николаевич – Ресей Федерациясы Үкіметінің Халықаралық ынтымақтастық департаментінің референті

ГРЯЗНОВ Михаил Борисович – Ресей Федерациясы Энергетика министрлігі Мұнай мен газды қайта өңдеу департаментінің директоры

ДАВЫДОВА Леся Евгеньевна –  Федералдық монополияға қарсы қызметтің Халықаралық экономикалық ынтымақтастық басқармасының бастығы

ДЕМИДЕНКО Дмитрий Павлович –  Федералдық көші-қон қызметі Шетелдік азаматтармен жұмысты ұйымдастыру департаменті басшысының орынбасары – Рұқсат беру-виза жұмысын ұйымдастыру басқармасының бастығы

ДЖАВАХЯН Асико Овиковна – Ресей Федерациясы Энергетика министрлігінің Заң департаменті директорының орынбасары

ДЖАФАРОВА Сабина Фархадовна – Ресей Федерациясы Экономикалық даму министрлігінің Кеден одағы органдарымен өзара іс-қимыл және ТМД елдерімен экономикалық ынтымақтастық департаменті салалық келісімдер бөлімінің жетекші сарапшы-маманы

ДМИТРИЕВ Максим Викторович – Ресей Федерациясы Экономикалық даму министрлігі Сыртқы экономикалық қызметті тарифтік реттеу және талдау департаментінің директоры

ДРОНОВ Алексей Александрович – Ресей Федерациясы Сыртқы істер министрлігі Құқық департаменті директорының орынбасары

ДРОНОВА Александра Викторовна – Ресей Федерациясы Әділет министрлігі Халықаралық құқық және ынтымақтастық департаментінің директоры

ДЬЯЧЕНКО Сергей Владимирович –  Ресей Федерациясының Женевадағы БҰҰ мен басқа да халықаралық ұйымдардың бөлімшелері жанындағы тұрақты өкілдігінің кеңесшісі

ЕВТУШЕНКО Сергей Николаевич – Ресей Федерациясы Үкіметінің Ақпараттық технологиялар және байланыс департаментінің референті

ЕГОРОВА Светлана Викторовна – Ресей Федерациясы Экономикалық даму министрлігінің Сыртқы экономикалық қызметті үйлестіру, дамыту және реттеу департаменті директорының орынбасары

ЕЖОВ Сергей Павлович –  Ресей Федерациясы Сыртқы істер министрлігі ТМД елдері бірінші департаментінде бөлім бастығы

ЖУКОВ Дмитрий Борисович – Федералдық кеден қызметінің Кедендік ресімдеуді және кедендік бақылауды ұйымдастыру бас басқармасының бастығы

ЗЕНЦОВА Ольга Викторовна – Ресей Федерациясы Әділет министрлігінің Халықаралық құқық және ынтымақтастық департаменті халықаралық экономикалық интеграцияны құқықтық қамтамасыз ету бөлімінің бастығы

ЗМЕЕВСКАЯ Татьяна Евгеньевна – Зияткерлік меншік жөніндегі федералдық қызметтің Мемлекеттік көрсетілетін қызметтерді ұсынуды ұйымдастыру басқармасының дараландыру құралдары бөлімінің бастығы

ЗУЙКОВ Максим Сергеевич – Ресей Федерациясы Еңбек және әлеуметтік қорғау министрлігі Халықты жұмыспен қамту департаментінің еңбек көші-қоны бөлімі бастығының орынбасары

ИВАНОВ Геннадий Евгеньевич – Тұтынушылардың құқықтарын қорғау және адамның саламаттылығы саласындағы қадағалау жөніндегі федералдық қызметтің Санитариялық қадағалау басқармасы бастығының орынбасары

ИВАНОВ Сергей Викторович – Ресей Федерациясы Орталық банкінің Халықаралық ынтымақтастық және қоғамдық коммуникациялар департаменті директорының орынбасары – Халықаралық ынтымақтастықты үйлестіру басқармасының бастығы

ИКРЯННИКОВ Сергей Евгеньевич – Ресей Федерациясы Экономикалық даму министрлігінің Келісімшарттық жүйені дамыту департаменті директорының орынбасары

ИСАЕВ Александр Андреевич – Ветеринариялық және фитосанитариялық қадағалау жөніндегі федералдық қызметтің Фитосанитариялық қадағалау, тұқымдық бақылау және астық сапасы басқармасының бастығы

ИСАКОВА Дарья Георгиевна – Ветеринариялық және фитосанитариялық қадағалау жөніндегі федералдық қызметтің Ветеринария саласындағы халықаралық ынтымақтастық және Дүниежүзілік сауда ұйымы шеңберіндегі инспекциялық жұмыс басқармасының шетелдермен ынтымақтастық бөлімінің бастығы

КАГАНОВ Вениамин Шаевич – Ресей Федерациясы Білім және ғылым министрінің орынбасары

КАГАНОВ Владимир Михайлович - Ресей Федерациясы Өнеркәсіп және сауда министрлігінің Көліктік және арнайы машина жасау департаменті директорының орынбасары

КАПРИЕЛОВА Юлия Александровна – Ресей Федерациясы Экономикалық даму министрлігінің Кеден одағы органдарымен өзара іс-қимыл және ТМД елдерімен экономикалық ынтымақтастық департаменті бірыңғай экономикалық саясат бөлімінің бас сарапшы-маманы

КВАСОВ Алексей Григорьевич – Ресей Федерациясы Президентінің Сараптама басқармасы бастығының орынбасары

КИБИРЕВА Вера Михайловна –  Ресей Федерациясы Ауыл шаруашылығы министрлігі Халықаралық ынтымақастық департаментінің бөлім бастығы

КИМ Ольга Эдуардовна – Ресей Федерациясы Үкіметінің Халықаралық ынтымақтастық департаментінің бөлім бастығы

КИРИЛЛОВА Алевтина Григорьевна – Тарифтер жөніндегі федералдық қызмет басшысының кеңесшісі

КИРЬЯКОВ Алексей Николаевич – Ресей Федерациясы Энергетика министрлігінің Халықаралық ынтымақтастық департаменті ТМД елдері бөлімінің бастығы

КИСЕЛЕВА Елена Николаевна –  Ресей Федерациясы Экономикалық даму министрлігінің Кеден одағы органдарымен өзара іс-қимыл және ТМД елдерімен экономикалық ынтымақтастық департаменті бірыңғай экономикалық саясат бөлімінің бастығы

КЛИМОВ Александр Алексеевич – Ресей Федерациясы Білім және ғылым министрінің орынбасары

КЛЮШНИКОВ Виктор Николаевич – Техникалық реттеу және метрология жөніндегі федералдық агенттіктің Техникалық реттеу және стандарттау басқармасының бастығы

КОБРИНЕЦ Николай Сергеевич – Ресей Федерациясы Үкіметінің Халықаралық ынтымақтастық департаменті директорының орынбасары

КОЗЫРЕВ Евгений Александрович –  Федералдық кеден қызметінің Кедендік ынтымақтастық басқармасы бастығының бірінші орынбасары

КОЛДИН Антон Владимирович – Ресей Федерациясы Байланыс және бұқаралық коммуникация министрлігінің Халықаралық ынтымақтастық департаменті шет мемлекеттермен ынтымақтастық бөлімінің бастығы

КОЛОТИЛОВА Ольга Николаевна – Ресей Федерациясы Өнеркәсіп және сауда министрлігі Фармацевтикалық және медициналық өнеркәсіпті дамыту департаментінің директоры

КОМАРОВА Светлана Владимировна – Ресей Федерациясы Еңбек және әлеуметтік қорғау министрлігінің Зейнетақымен қамсыздандыру департаменті директорының орынбасары

КОРОЛЕВА Екатерина Михайловна –  Ресей Федерациясы Экономикалық даму министрлігі Кеден одағы органдарымен өзара іс-қимыл және ТМД елдерімен экономикалық ынтымақтастық департаментінің бірыңғай экономикалық саясат бөлімі бастығының орынбасары

КОСТЫЛЕВА Ольга Федоровна – Техникалық реттеу және метрология жөніндегі федералдық агенттіктің Техникалық реттеу және стандарттау басқармасы бастығының орынбасары – агроөнеркәсіптік өндіріс пен жеңіл өнеркәсіп өнімдерін техникалық реттеу және стандарттау бөлімінің бастығы

КУЗНЕЦОВ Александр Юрьевич – Ресей Федерациясы Байланыс және бұқаралық коммуникация министрлігінің Құқық департаменті директорының орынбасары

КУЗНЕЦОВ Антон Сергеевич – Ресей Федерациясы Мәдениет министрлігінің Халықаралық ынтымақтастық департаменті ТМД және отандастармен жұмыс бөлімінің бас сарапшы-маманы

ЛЕОНИДОВ Константин Владимирович – Ресей Федерациясы Өнеркәсіп және сауда министрлігінің Техникалық реттеу және өлшем бірліктерін қамтамасыз ету саласындағы мемлекеттік саясат департаментінің директоры

ЛИТВИН Евгения Вадимовна – Ресей Федерациясы Сыртқы істер министрлігі ТМД елдері бірінші департаментінің үшінші хатшысы

ЛОБАЧ Дмитрий Анатольевич – Ресей Федерациясының Ангола Республикасындағы Төтенше және Өкілетті Елшісі

ЛОЗОВАЯ Анна Николаевна –  Ресей Федерациясы Қаржы министрлігінің Салықтық және кедендік-тарифтік саясат департаменті жанама салықтар бөлімінің бастығы

ЛОКТИОНОВА Елена Александровна – Ресей Федерациясы Экономикалық даму министрлігінің Кеден одағы органдарымен өзара іс-қимыл және ТМД елдерімен экономикалық ынтымақтастық департаменті ұлтүсті институттарды дамыту бөлімінің жетекші кеңесшісі

ЛУКАНИНА Альбина Викторовна –  Ресей Федерациясы Экономикалық даму министрлігінің Сыртқы экономикалық қызметті үйлестіру, дамыту және реттеу департаменті сыртқы нарықтарға қол жеткізу бөлімінің жетекші кеңесшісі

МАКСИМКИНА Елена Анатольевна – Ресей Федерациясы Денсаулық сақтау министрлігі Дәрілік қамтамасыз ету және медициналық бұйымдар айналысын реттеу департаментінің директоры

МАЛЬКОВА Виктория Валерьевна – Ресей Федерациясы Сыртқы істер министрлігі ТМД елдері бірінші департаментінің бірінші хатшысы

МАНИЛОВА Алла Юрьевна – Ресей Федерациясы Мәдениет министрінің орынбасары

МАТВЕЕВ Александр Анатольевич – Ресей Федерациясы Президентінің Сыртқы саясат жөніндегі басқармасының референті

МЕДВЕДКОВ Максим Юрьевич – Ресей Федерациясы Экономикалық даму министрлігі Сауда келіссөздері департаментінің директоры

МЕЛИССИНА Людмила Львовна – Зияткерлік меншік жөніндегі федералдық қызметтің Халықаралық ынтымақтастық басқармасы өңірлік интеграция бөлімінің бастығы

МИГИН Сергей Владимирович – Аккредиттеу жөніндегі федералдық қызмет басшысының орынбасары

МИЗЕРКОВ Олег Сергеевич – Ресей Федерациясы Экономикалық даму министрлігінің Кеден одағы органдарымен өзара іс-қимыл және ТМД елдерімен экономикалық ынтымақтастық департаментінің директоры

МОРОЗОВА Елена Сергеевна – Ресей Федерациясы Еңбек және әлеуметтік қорғау министрлігінің Құқықтық және халықаралық қызмет департаменті ТМД елдері бөлімінің бастығы

МУРАВЬЕВ Сергей Михайлович – Ресей Федерациясы Денсаулық сақтау министрлігі Халықаралық ынтымақтастық және жұртшылықпен байланыс департаментінің директоры

НАЗАРОВ Антон Вячеславович – Ресей Федерациясы Мәдениет министрлігінің Халықаралық ынтымақтастық департаменті ТМД және отандастармен жұмыс бөлімінің бастығы

НАСРУТДИНОВ Мурад Магомедович – Ресей Федерациясы Сыртқы істер министрлігі Құқық департаментінің бөлім бастығының орынбасары

НЕМСАДЗЕ Мариам Левановна – Ресей Федерациясы Әділет министрлігінің Халықаралық құқық және ынтымақтастық департаменті халықаралық экономикалық интеграцияны құқықтық қамтамасыз ету бөлімінің бас сарапшы-маманы

НИКИШИНА Вероника Олеговна – Ресей Федерациясы Үкіметі Төрағасының Бірінші орынбасарының көмекшісі

ОЙНВИД Татьяна Николаевна – Федералдық монополияға қарсы қызметтің Халықаралық экономикалық ынтымақтастық басқармасы бастығының орынбасары

ОЛЕРСКИЙ Виктор Александрович – Ресей Федерациясы Көлік министрінің орынбасары

ОСАУЛЕНКО Лидия Николаевна –  Тұтынушылардың құқықтарын қорғау және адамның саламаттылығы саласындағы қадағалау жөніндегі федералдық қызметтің Құқық басқармасы бастығының орынбасары

ПАЛАТОВА Татьяна Владимировна – Ресей Федерациясы Орталық банкінің Халықаралық ынтымақтастық және қоғамдық коммуникация департаментінің Халықаралық ынтымақтастықты үйлестіру басқармасы интеграциялық ынтымақтастық бөлімінің бастығы

ПАРФЕНЦЕВА Ольга Александровна – Ресей Федерациясы Экономикалық даму министрлігінің Экономика, әлеуметтік даму және басым бағдарламалар департаменті демографиялық саясаттың экономикалық аспектілері бөлімінің бастығы

ПЕРСИКОВА Ирина Сергеевна – Федералдық салық қызметінің Заңды тұлғаларға салық салу басқармасының қосылған құн салығы бөлімі бастығының орынбасары

ПЛЕШКИН Михаил Леонидович – Ресей Федерациясы Энергетика министрлігінің Халықаралық ынтымақтастық департаменті директорының орынбасары

ПОДОЛЬСКАЯ Марина Олеговна – Ресей Федерациясы Қаржы министрлігі Халықаралық қаржылық қатынастар департаментінің референті

ПОМЧАЛОВА Елена Валентиновна – Тарифтер жөніндегі федералдық қызмет Басшысының орынбасары

ПУДОВ Андрей Николаевич – Ресей Федерациясы Еңбек және әлеуметтік қорғау министрінің орынбасары

РАДИШЕВСКАЯ Ирина Владимировна – Ресей Федерациясы Ауыл шаруашылығы министрі Халықаралық ынтымақтастық департаментінің бөлім бастығының орынбасары

РЕШЕТОВА Ольга Михайловна – Ресей Федерациясы Үкіметі Төрағасының Бірінші орынбасары Хатшылығының бас кеңесшісі

РОДИЧЕВ Валерий Дмитриевич – Ресей Федерациясы Экономикалық даму министрлігінің Шағын және орта кәсіпкерлікті және бәсекелестікті дамыту департаменті тауарлар мен көрсетілетін қызметтер нарығында бәсекелестікті дамыту бөлімінің жетекші консультанты

РОЖНЕВ Максим Юрьевич –  Ресей Федерациясы   Экономикалық даму министрлігінің Кеден одағы органдарымен өзара іс-қимыл және ТМД елдерімен экономикалық ынтымақтастық департаменті бірыңғай экономикалық саясат бөлімінің кеңесшісі

РЯБИНИН Антон Леонидович – Ресей Федерациясы Үкіметінің Халықаралық ынтымақтастық департаментінің бас кеңесшісі

РЯБОВА Ирина Владимировна –  Ресей Федерациясы   Экономикалық даму министрлігінің Кеден одағы органдарымен өзара іс-қимыл және ТМД елдерімен экономикалық ынтымақтастық департаменті бірыңғай экономикалық саясат бөлімінің референті

САДИКОВ Евгений Алексеевич – Ресей Федерациясы Президентінің Сыртқы саясат жөніндегі басқармасының департамент кеңесшісі

САЛАГАЙ Олег Олегович – Ресей Федерациясы Денсаулық сақтау министрлігінің Халықаралық ынтымақтастық және жұртшылықпен байланыс департаменті директорының орынбасары

САМКОВ Вячеслав Михайлович – "Бүкілресейлік машина жасауда стандарттау және сертификаттау ғылыми-зерттеу институты" федералдық мемлекеттік біртұтас кәсіпорынның ғылыми жұмыс жөніндегі директорының бірінші орынбасары

СВЕРЧКОВА Ольга Анатольевна – Ресей Федерациясы Экономикалық даму министрлігінің Кеден одағы органдарымен өзара іс-қимыл және ТМД елдерімен экономикалық ынтымақтастық департаменті ұлтүсті институттарды дамыту бөлімінің референті

СЕМЕНЕНКО Игор Владимирович – Ресей Федерациясы Президентінің Сыртқы саясат жөніндегі басқармасының департамент бастығы

СЕМЕНОВА Татьяна Владимировна – Ресей Федерациясы Денсаулық сақтау министрлігі Медициналық білім және денсаулық сақтау ісіндегі кадр саясаты департаментінің директоры

СИДОРЯК Надежда Владимировна –  Федералдық көші-қон қызметінің Сыртқы байланыс басқармасының қызметті халықаралық-құқықтық қамтамасыз ету бөлімінің айрықша тапсырмалар жөніндегі аға инспекторы

СЛЕПЧЕНКО Алексей Викторович – Тұтынушылардың құқықтарын қорғау және адамның саламаттылығы саласындағы қадағалау жөніндегі федералдық қызметтің Мемлекеттік санитариялық-эпидемиологиялық қадағалау жүйесінің қызметін ұйымдастыру басқармасы бастығының орынбасары

СМАХТИН Дмитрий Арнольдович – Ресей Федерациясы Үкіметінің Халықаралық ынтымақтастық департаментінің бөлім бастығының орынбасары

СМИРНОВ Виктор Михайлович –  Ресей Федерациясы Білім және ғылым министрлігі Халықаралық департамент директорының орынбасары

СМЫШЛЯЕВА Полина Александровна – Ресей Федерациясы Ауыл шаруашылығы министрлігінің Ветеринария департаменті директорының орынбасары

СТАРОСТИНА Виолетта Сергеевна – Ресей Федерациясы Әділет министрлігінің Халықаралық құқық және ынтымақтастық департаменті бөлімінің жетекші кеңесшісі

СТЕБУНОВА Тамара Ивановна – Тарифтер жөніндегі федералдық қызмет басшысының орынбасары

СУХОПАРОВ Дмитрий Иванович –   "РусГидро" ашық акционерлік қоғамының басқарма төрағасының кеңесшісі - бас директоры

ТАРАСОВ Артем Олегович – Ресей Федерациясы Экономикалық даму министрлігінің Кеден одағы органдарымен өзара іс-қимыл және ТМД елдерімен экономикалық ынтымақтастық департаменті салалық келісімдер бөлімінің бас сарапшы-маманы

ТОВКАЙЛО Максим Витальевич – "Аксель Шпрингер Раша" жабық акционерлік қоғамының Forbes.ru сайтының шеф-редакторы

ТРАВНИКОВ Дмитрий Владимирович – Зияткерлік меншік жөніндегі федералдық қызметтің Мемлекеттік көрсетілетін қызметтерді ұсынуды ұйымдастыру басқармасының бастығы

ТРЕФИЛОВ Денис Анатольевич – Ресей Федерациясы Ауыл шаруашылығы министрлігі Халықаралық ынтымақтастық департаментінің директоры

ТРУНИН Илья Вячеславович –  Ресей Федерациясы Қаржы министрлігі Салықтық және кедендік-тарифтік саясат департаментінің директоры

УСАЧЕВ Анатолий Николаевич – Ресей Федерациясы Экономикалық даму министрлігінің Экономика секторларын дамыту департаменті директорының орынбасары

ФЕДОРОВА Анастасия Александровна – Ресей Федерациясы Экономикалық даму министрлігі Кеден одағы органдарымен өзара іс-қимыл және ТМД елдерімен экономикалық ынтымақтастық департаментінің салалық келісімдер бөлімі бастығының орынбасары

ФЕДЬКО Татьяна Анатольевна – Ресей Федерациясы Экономикалық даму министрлігінің Құқық департаменті халықаралық экономикалық заңнама бөлімінің бастығы

ФЕСЬКО Елена Анатольевна –  Ресей Федерациясы Өнеркәсіп және сауда министрлігінің Сыртқы сауда қызметін мемлекеттік реттеу департаменті директорының орынбасары

ХВОСТУНКОВ Андрей Николаевич – Тарифтер жөніндегі федералдық қызметтің Көлікті реттеу басқармасы бастығының орынбасары

ХИЗЕВА Наталия Андреевна – Ресей Федерациясы Әділет министрлігінің Халықаралық құқық және ынтымақтастық департаменті халықаралық экономикалық интеграцияны құқықтық қамтамасыз ету бөлімінің бас сарапшы-маманы

ЦЕЦИНОВСКИЙ Антон Михайлович – Ресей Федерациясы Экономикалық даму министрлігінің Саудалық келіссөздер департаменті тауарлармен сауда-саттық бөлімінің бастығы

ЦУКАНОВ Максим Валерьевич – Ветеринариялық және фитосанитариялық қадағалау жөніндегі федералдық қызметтің Сыртқы сауда операциялары кезіндегі және көліктегі ветеринариялық қадағалау басқармасы бастығының орынбасары

ЦЫДЕНОВ Алексей Самбуевич – Ресей Федерациясы Көлік министрінің орынбасары

ЦЫНДЫМЕЕВ Арсалан Гармаевич – Ресей Федерациясы Денсаулық сақтау министрлігі Дәрілік заттар айналысын мемлекеттік реттеу департаментінің директоры

ЧЕРНЕНКО Андрей Владимирович – Ресей Федерациясы Байланыс және бұқаралық коммуникация министрлігі Ақпараттандыру жөніндегі жобалар департаментінің директоры

ЧИЖОВА Ирина Александровна – Федералдық кеден қызметінің Федералдық кірістерді басқару және тарифтік реттеу бас басқармасы бастығының орынбасары

ШАМИНА Мария Александровна –  Ресей Федерациясы Экономикалық даму министрлігінің Саудалық келіссөздер департаменті көрісетілетін қызметтер және инвестициялар бөлімінің бастығы

ШЕВЕЛЕВА Наталия Сергеевна –  Ресей Федерациясы Экономикалық даму министрлігінің Саудалық келіссөздер департаменті көрісетілетін қызметтер және инвестициялар бөлімінің жетекші кеңесшісі

ШИПИЛОВ Василий Петрович –  Ресей Федерациясы Экономикалық даму министрлігінің Тарифтерді, инфрақұрылымдық реформаларды және энергия тиімділігін мемлекеттік реттеу департаменті көлік пен байланысты реформалау бөлімінің бастығы

ШИПОВ Савв Витальевич – Аккредиттеу жөніндегі федералдық қызметтің басшысы

ШИШАЕВ Алексей Иванович – Ресей Федерациясы Президентінің Сыртқы саясат жөніндегі басқармасы бастығының орынбасары

ШЕКОЛИНСКИЙ Николай Николаевич – Ресей Федерациясы Үкіметінің Халықаралық ынтымақтастық департаментінің бас кеңесшісі

ШТУНДЮК Дмитрий Александрович – Ресей Федерациясы Ауыл шаруашылығы министрлігінің Өсімдік шаруашылығы, өсімдіктерді химияландыру және қорғау департаменті директорының орынбасары

ЭКСУЗЯН Эльга Фридолиновна – Ресей Федерациясы Сыртқы істер министрлігі ТМД елдері бірінші департаментінің хатшы-референті

ЮДЕНКОВА Татьяна Васильевна – Техникалық реттеу және метрология жөніндегі федералдық агенттіктің Техникалық реттеу және стандарттау басқармасы сәйкестікті және сапаны растау бөлімінің бастығы

ЯКОВЕНКО Наталия Юрьевна – Федералдық монополияға қарсы қызметтің Көлік пен байланысты бақылау басқармасы бастығының орынбасары



Еуразиялық экономикалық комиссиядан



АБРАМЕНКО Алеся Николаевна – Монополияға қарсы реттеу департаментінің агроөнеркәсіптік кешен саласын талдау және тергеп-тексерулер жүргізу бөлімі бастығының орынбасары

АБРАМОВ Михаил Георгиевич – Хаттама және ұйымдастырушылық қамтамасыз ету департаментінің коммуникациялық технологиялар бөлімінің кеңесшісі

АЗАРОВ Антон Валерьевич – Интеграцияны дамыту департаментінің Халықаралық өзара іс-қимыл бөлімінің бастығы

АКИМОВА Евгения Эдуардовна – Санитариялық, фитосанитариялық және ветеринариялық шаралар департаментінің санитариялық шаралар бөлімінің кеңесшісі

АҚПАНБАЕВА Дина Қияшқызы – Кедендік-тарифтік және тарифтік емес реттеу департаменті директорының орынбасары

АЛЕКСЕЕВА Татьяна Юрьевна – Хаттама және ұйымдастырушылық қамтамасыз ету департаменті директорының орынбасары

ӘЛИЕВ Самат Бикитұлы – Кәсіпкерлік қызметті дамыту департаменті директорының орынбасары

АНИКЬЕВ Артем Валентинович – Сауда саясаты департаменті директорының орынбасары

АРМАНД Юрий Владимирович – Сауда жөніндегі Алқа мүшесінің (Министрдің) көмекшісі

АСАНСЕЙІТОВА Саадат Мұханбетқызы – Интеграцияны дамыту департаменті директорының орынбасары

БАДЕЙНОВ Владимир Станиславович – Кедендік инфрақұрылым департаментінің кеден органдарының ақпараттық жүйелерін интеграциялау бөлімінің бастығы

БАЙГАРИН Равшан Шамильевич – Интеграцияны дамыту департаментінің жинақтау және жоспарлау бөлімінің бастығы

БАИГОТ Мария Степановна – Агроөнеркәсіптік саясат департаменті агроөнеркәсіптік саясат, мемлекетаралық бағдарламалар мен жобалар бөлімінің бастығы

БАҚЫТБЕККЫЗЫ Дария – Ішкі нарықты қорғау департаментінің әдіснама бөлімінің бастығы

БАРАНЕНКО Василий Иванович – Техникалық реттеу және аккредиттеу департаментінің стандарттау мен метрологияда жұмысты үйлестіру бөлімінің бастығы

БАСАЛАЕВА Оксана Сергеевна – Монополияға қарсы реттеу департаментінің сауда және көрсетілетін қызметтер саласын талдау және тергеп-тексерулер жүргізу бөлімі бастығының орынбасары

БАТРАКОВА Наталья Валерьевна – Кедендік инфрақұрылым департаментінің кеден органдарының ақпараттық жүйелерін интеграциялау бөлімінің кеңесшісі

БЕЙСИМБЕКОВ Эльдар Жандосынұлы – Макроэкономикалық саясат департаменті директорының орынбасары

БОРУШКО Елена Васильевна – Статистика департаменті директорының орынбасары

БРИЧЕВА Елена Николаевна – Кеден заңнамасы және құқық қолдану практикасы департаменті директорының орынбасары

БУРКУЛОВА Әйгерім Сағидуллақызы – Бәсекелестік саясат және мемлекеттік сатып алу саласындағы саясат департаментінің халықаралық ынтымақтастық бөлімінің консультанты

БУТЕВИЧ Сергей Анатольевич – Хаттама және ұйымдастырушылық қамтамасыз ету департаментінің хаттама бөлімі бастығының орынбасары

ВОЛКОВА Елена Анатольевна – Кедендік-тарифтік және тарифтік емес реттеу департаментінің тарифтік емес реттеу бөлімінің бастығы

ГАЛАНАМАТИС Александр Николаевич –  Кедендік инфрақұрылым департаменті директорының орынбасары – тәуекелдерді бақылауды, талдауды және басқаруды автоматтандыру бөлімінің бастығы

ГАЛЛЯМОВА Зульфия Назимовна – Қаржы департаментінің Бюджеттік жоспарлау және қаржыландыру бөлімінің бастығы

ГОТОВСКИЙ Александр Владиславович – Өнеркәсіптік саясат департаменті директорының орынбасары

ГРОМОВ Антон Игоревич – Хаттама және ұйымдастырушылық қамтамасыз ету департаменті хаттама бөлімі бастығының орынбасары

ДЕДКОВ Евгений Дмитриевич    –  Алқа төрағасының көмекшісі

ДЕМИДКИНА Ольга Вячеславовна   – Сауда саясаты департаментінің екіжақты және өңірлік ынтымақтастық бөлімінің кеңесшісі

ДЖҰМАҒАЛИЕВ Омар Калимзянұлы – Санитариялық, фитосанитариялық және ветеринариялық шаралар департаментінің фитосанитариялық шаралар бөлімі бастығының орынбасары

ДОЛГОПОЛОВ Петр Иванович – Статистика департаменті директорының орынбасары

ДОРОШКЕВИЧ Валерий Александрович – Құқық департаменті директорының орынбасары

ДҮЙСЕБАЕВ Сержан Дәмебайұлы – Кеден заңнамасы және құқық қолдану практикасы департаменті директорының орынбасары

ДҮЙСЕНБАЙ Думан Түсіпұлы – Көлік және инфрақұрылым департаменті көліктік бақылау бөлімінің бастығы

ДЬЯЧЕНКО Алексей Игоревич – Ішкі нарықты қорғау департаменті директорының орынбасары

ЕВДОКИМОВ Сергей Викторович – Өнеркәсіптік саясат департаменті директорының орынбасары

ЕРЕМЯН Галина Петровна – Ішкі нарықты қорғау департаментінің импортты талдау бөлімі бастығының орынбасары

ЖАРДЕЦКИЙ Вадим Федорович – Кедендік ынтымақтастық жөніндегі Алқа мүшесінің (Министрдің) көмекшісі

ЗАВЬЯЛОВ Артур Владимирович – Сауда саясаты департаментінің преференциалдық сауданың шығу тегі мен шарттарының қағидалары бөлімінің бастығы

ЗАВЬЯЛОВ Дмитрий Олегович – Алқа төрағасының көмекшісі

ЗАЙЦЕВ Дмитрий Александрович – Қаржы саясаты департаменті ақша-кредит және валюта саясаты бөлімінің бастығы

ЗАЙЦЕВА Светлана Викторовна – Энергетика департаменті электр энергетикасы және атом саясаты бөлімінің кеңесшісі

ЗАХАРОВ Андрей Владимирович   – Ішкі нарықты қорғау департаменті директорының орынбасары

ЗАХАРОВ Валерий Евгеньевич – Кәсіпкерлік қызметті дамыту департаменті кәсіпкерлік, көрсетілетін қызметтер және инвестициялар бөлімінің бастығы

ЗИНЧЕНКО Александр Прокофьевич – Алқа төрағасының көмекшісі

ЗУБИК Наталья Львовна – Кеден заңнамасы және құқық қолдану практикасы департаменті директорының орынбасары

ЗУЕВ Станислав Юрьевич – Хаттама және ұйымдастырушылық қамтамасыз ету департаменті директорының орынбасары

ИБРАЕВ Ілияс Елубайұлы – Экономика және қаржы саясатсы жөніндегі Алқа мүшесінің (Министрдің) көмекшісі

ИВАННИКОВ Иван Владимирович – Хаттама және ұйымдастырушылық қамтамасыз ету департаменті ұйымдастырушылық қамтамасыз ету бөлімінің бастығы

ИЗМАЙЛОВ Елена Юрьевна – Кәсіпкерлік қызметті дамыту департаменті зияткерлік меншікті құқықтық қорғау бөлімінің бастығы

ИСАДЫҚОВА Аида Болатқызы – Құқық департаменті кодтау, халықаралық-құқықтық жұмыс және депозитарийлік функцияларды жүзеге асыру бөлімінің консультанты

ИСКОСКОВА Марина Вячеславовна – Кеден заңнамасы және құқық қолдану практикасы департаментінің кеден заңнамасы бөлімінің бастығы

ИСЛАМОВА Галина Рашидовна – Макроэкономикалық саясат деепартаменті директорының орынбасары

ИСПУЛЛАЕВ Ақын Имаханұлы – Санитариялық, фитосанитариялық және ветеринариялық шаралар департаменті ветеринариялық шаралар бөлімінің кеңесшісі

ИШЕВСКАЯ Анастасия Александровна – Техникалық реттеу және аккредиттеу департаментінің әдіснама бөлімі бастығының орынбасары

КАБАКОВ Владимир Сергеевич – Кеден заңнамасы және құқық қолдану практикасы департаменті кедендік төлемдер, кедендік құн және шығу тегі елі бөлімінің бастығы

КАРАСЕВА Вероника Львовна – Энергетика және инфрақұрылым жөніндегі Алқа мүшесінің (Министрдің) көмекшісі

КАРАЧУН Олег Ришардович – Макроэкономикалық саясат департаментінің әдіснама және талдау бөлімі бастығының орынбасары

КАРЯКИНА Ольга Аркадьевна – Қаржы департаменті директорының орынбасары

КАСЬЯНОВ Василий Олегович –  Интеграцияның негізгі бағыттары және макроэкономика жөніндегі Алқа мүшесінің (Министрдің) көмекшісі

КЛИМОВИЧ Олег Леонидович –  Өнеркәсіп және агроөнеркәсіптік кешен жөніндегі Алқа мүшесінің (Министрдің) көмекшісі

КОВАЛЕВ Вадим Викторович – Қаржы саясаты департаменті директорының орынбасары

КОЗЛОВСКАЯ Татьяна Николаевна – Бәсекелестік саясат және мемлекеттік сатып алу саласындағы саясат департаменті мемлекеттік сатып алу бөлімінің кеңесшісі

КОЗЛОВА Ольга Андреевна – Ішкі нарықты қорғау департаменті импортты талдау бөлімінің бастығы

КОЛОБАНОВ Сергей Николаевич – Энергетика департаменті директорының орынбасары

КОЛОСОВА Марина Викторовна – Интеграцияны дамыту департаменті директорының орынбасары

КОРНАКОВ Дмитрий Владимирович – Санитариялық, фитосанитариялық және ветеринариялық шаралар департаменті санитариялық шаралар бөлімінің кеңесшісі

КОСОВА Светлана Александровна – Істерді басқару департаментінің персоналмен жұмыс бөлімінің бастығы

КОТЕЛЕНЦ   Александр   Владимирович –  Алқа төрағасының көмекшісі

КРАВЧЕНКО Валентина Васильевна – Қаржы саясаты департаменті директорының орынбасары

КРАВЧУК Анна Михайловна – Техникалық реттеу және аккредиттеу департаменті ЕЭК шешімдерінің орындалуын үйлестіру бөлімінің кеңесшісі

КРОХИН Павел Владимирович – Санитариялық, фитосанитариялық және ветеринариялық шаралар департаменті ветеринариялық шаралар бөлімінің кеңесшісі

КУЗНЕЦОВА Елена Анатольевна – Монополияға қарсы реттеу департаменті құқық қолдану практикасы және бәсекелестік қағидаларын бұзушылық туралы істерді қарауға материалдарды дайындау бөлімінің бастығы

КУЗЬМИЧ Людмила Анатольевна – Кедендік инфрақұрылым департаменті директорының орынбасары

КУШНИРЕНКО Елена Андреевна   – Сауда саясаты департаменті көрсетілетін қызметтер және инвестициялар бөлімінің бастығы

ЛАМКОВ Вадим Владимирович – Кедендік-тарифтік және тарифтік емес реттеу департаментінің тарифтік емес реттеу бөлімі бастығының орынбасары

ЛАРИОНОВА Лариса Николаевна – Ішкі нарықты қорғау департаменті залалды анықтау бөлімінің бастығы

ЛИПИН Андрей Станиславович – Макроэкономикалық саясат департаменті директорының орынбасары

ЛОЗИН Александр Сергеевич – Ақпараттық технологиялар департаменті КО және ЕЭК интерацияланған ақпараттық жүйесін құру және дамыту жөніндегі жұмыстарды үйлестіру бөлімінің бастығы

МАЛДЫБАЕВ Қазыбек Малдыбайұлы –  Энергетика және инфрақұрылым жөніндегі Алқа мүшесінің (Министрдің) көмекшісі

МАМБЕТӘЛИЕВ Нұрматбек Таджиұлы –  Қаржы саясаты департаментінің салық саясаты бөлімінің бастығы

МАРТИНЕС Рафаэль Рафаэльевич – Ақпараттық технологиялар департаменті электрондық құжаттарды ақпараттық қамтамасыз ету және біріздендіру бөлімінің кеңесшісі

МАРТЫНОВ Антон Валерьевич – Монополияға қарсы реттеу департаменті өнеркәсіп саласын талдау және тергеп-тексерулер жүргізу бөлімінің кеңесшісі

МАЯНОВА Галина Михайловна – Кедендік-тарифтік және тарифтік емес реттеу департаменті директорының орынбасары

МЕЛЬНИК Алексей Михайлович – Алқа төрағасының көмекшісі

МЕРЗЛОВ Дмитрий Евгеньевич – Өнеркәсіптік саясат департаменті өнеркәсіптік саясат мәселелері бойынша өзара іс-қимыл бөлімінің кеңесшісі

МОИСЕЕВ Александр Анатольевич – Сауда саясаты департаменті сыртқы нарықтарға қол жеткізу және саудалық дауларды ретке келтіру бөлімінің кеңесшісі

МОЛОКОВА Арина Викторовна – Техникалық реттеу және аккредиттеу департаменті директорының орынбасары

МОРОЧКОВА Зоя Михайловна – Интеграцияны дамыту департаменті талдау және перспективалық даму бөлімінің бастығы

МУСТАФАЕВ Рафаель Низамович   – Көлік және инфрақұрылым департаментінің табиғи монополиялар бөлімі бастығының орынбасары

МҰХАМЕДИЕВА Әсем -  Монополияға қарсы реттеу департаменті ОЭК нарықтарын талдау және тергеп-тексерулер жүргізу бөлімінің бастығы

МУХИНА Марина Юрьевна – Құқық департаменті құқықтық редакциялау бөлімінің бастығы

НАСУТ Сергей Викторович – Қаржы саясаты департаменті төлемдер және бюджет саясаты саласындағы үйлестіру бөлімінің бастығы

НАУМОВ Александр Александрович   – Құқық департаменті мониторинг ұйымдастыру және сот-құқықтық жұмыс бөлімінің бастығы

НЕГРЕЙ Сергей Викторович –  Көлік және инфрақұрылым департаменті директорының орынбасары

НИКИТИНА Вера Викторовна – Қаржы департаменті директорының орынбасары

НИСТЮК Александр Иванович –  Кеден заңнамасы және құқық қолдану практикасы департаменті кедендік операциялар және кедендік бақылау бөлімінің бастығы

ОЕКЕНОВ Арман Мақсатқанұлы –   Хаттама және ұйымдастырушылық қамтамасыз ету департаменті директорының орынбасары

ПАВЛОВА Мария Александровна – Өнеркәсіптік саясат департаменті өнеркәсіптік субсидиялар бөлімінің консультанты

ПАВЛЮК Владимир Иосифович – Істерді басқару департаменті көлік бөлімінің бастығы

ПЕТКЕВИЧ Мария Иосифовна – Істерді басқару департаменті директорының орынбасары

ПЕТРОВ Валерий Иванович – Хаттама және ұйымдастырушылық қамтамасыз ету департаменті баспасөз бөлімінің бастығы

ПЛАШКОВА Оксана Ивановна    –  Техникалық реттеу мәселелері жөніндегі Алқа мүшесінің (Министрдің) көмекшісі

ПОДГОРНОВА Алла Борисовна – Тарифтік-кедендік және тарифтік емес реттеу департаменті кедендік-тарифтік реттеу, жеңілдіктер және преференциялар бөлімінің кеңесшісі

ПОЛОЗКОВ Андрей Анатольевич –  Техникалық реттеу және аккредиттеу департаменті техникалық регламенттерді әзірлеу бөлімінің бастығы

ПУСТОВАЛОВ Сергей Викторович – Қаржы департаменті қаржылық сараптама және шарттық жұмыс бөлімінің бастығы

РАКОВИЧ Елена Васильевна – Кедендік-тарифтік және тарифтік емес реттеу департаменті кедендік-тарифтік реттеу, жеңілдіктер және преференциялар бөлімінің бастығы

РОМАШКИН Роман Анатольевич –  Агроөнеркәсіптік кешен департаменті директорының орынбасары

РУКАС Николай Иванович – Құқық департаменті директорының орынбасары

РЫКОВ Артем Петрович – Хаттама және ұйымдастырушылық қамтамасыз ету департаментінің жоспарлау және үйлестіру жиынтық талдамалық бөлімінің бастығы

РЫМАШЕВСКИЙ Юрий Владимирович – Энергетика департаменті директорының орынбасары

САВЧЕНКО Владимир Владимирович – Бәсекелестік саясат және мемлекеттік сатып алу саласындағы саясат департаменті мемлекеттік сатып алу бөлімінің бастығы

САҚАЕВ   Марат Рустамұлы – Алқа төрағасының көмекшісі

САЛЬНИКОВ Алексей Александрович – Хаттама және ұйымдастырушылық қамтамасыз ету департаментінің ұйымдастырушылық қамтамасыз ету бөлімі бастығының орынбасары

САМОЙЛОВА Наталия Ивановна –   Кедендік-тарифтік және тарифтік емес реттеу департаменті директорының орынбасары

САНҚҰБАЕВ Әмірбек Буриұлы   –  Қаржы саясаты департаменті қаржылық нарықтар бөлімінің бастығы

САРБАЕВА Мария Александровна – Істерді басқару департаментінің мүлікті басқару бөлімі бастығының орынбасары

СВИРИНА Надежда Петровна – Агроөнеркәсіптік саясат департаменті ЕЭК мүше мемлекеттердің агроөнеркәсіптік кешендерінің дамуын мониторингілеу және талдау бөлімінің консультанты

СЕКЕРБАЕВА Динара Қабиқызы –  Кеден заңнамасы және құқық қолдану практикасы департаменті перспективалы кедендік технологиялар бөлімінің бастығы

СОКОЛОВСКАЯ Светлана Леонидовна – Техникалық реттеу және аккредиттеу департаменті сәйкестікті бағалау және аккредиттеу саласындағы үйлестіру бөлімінің бастығы

СОКОЛОВА Анна Юрьевна –  Интеграцияны дамыту департаменті нормативтік-құқықтық база бөлімінің бастығы

СОЛОНЕЦ Татьяна Михайловна     – Техникалық реттеу мәселелері жөніндегі Алқа мүшесінің (Министрдің) көмекшісі

СМАХТИНА Марина Викторовна –  Хаттама және ұйымдастырушылық қамтамасыз ету департаментінің баспасөз бөлімі бастығының орынбасары

СМИРНОВА Ольга Владимировна   –  Құқық департаментінің кодтау, халықаралық-құқықтық жұмыс және депозитарийлік функцияларды жүзеге асыру бөлімі бастығының орынбасары

СОСКОВЦ Денис Александрович – Хаттама және ұйымдастырушылық қамтамасыз ету департаменті директорының орынбасары

СУСЛИНА Елена Николаевна – Ақпараттық технологиялар департаменті электрондық құжаттарды ақпараттық қамтамасыз ету және біріздендіру бөлімінің бастығы

ТЕРЕНТЬЕВА Анжелика Евгеньевна – Құқық департаменті құқықтық редакциялау бөлімінің консультанты

ТИХОНОВА Юлию Викторовна –  Құқық департаментінің кодтау, халықаралық-құқықтық жұмыс және депозитарийлік функцияларды жүзеге асыру бөлімі бастығының орынбасары

ТОКАРЕВА Маргарита Александровна – Бәсекелестік және монополияға қарсы реттеу жөніндегі Алқа мүшесі (Министр) Хатшылығының кеңесшісі

ТОҚРАЕВА Қарлығаш Еламанқызы – Агроөнеркәсіптік саясат департаменті агроөнеркәсіптік саясат мәселелері жөніндегі іс-қимыл бөлімінің кеңесшісі

ТРУБАРОВ Сергей Владимирович – Энергетика және инфрақұрылым жөніндегі Алқа мүшесінің (Министрдің) көмекшісі

ФЕДОРКОВ Евгений Александрович – Істерді басқару департаменті директорының орынбасары

ХАРЛАМЕНКОВА Инна Феликсовна – Кедендік ынтымақтастық жөніндегі Алқа мүшесінің (Министрдің) көмекшісі

ЦЫБУЛЬНИК Людмила Викторовна – Өнеркәсіптік саясат департаменті өнеркәсіптік субсидиялау бөлімінің бастығы

ЧЕСНОКОВА Татьяна Николаевна – Бәсекелестік саясат және мемлекеттік сатып алу саласындағы саясат департаменті бәсекелестік заңнама және әдіснама бөлімінің бастығы

ЧИРКОВА Юлия Сергеевна – Техникалық реттеу және аккредиттеу департаменті техникалық реттеу әдіснамасы бөлімінің бастығы

ЧИСТЯКОВА Александра Александровна – Құқық департаменті кодтау, халықаралық-құқықтық жұмыс және депозитарийлік функцияларды жүзеге асыру бөлімінің бастығы

ШИЛИНА Екатерина Анатольевна – Интеграцияның негізгі бағыттары және макроэкономика жөніндегі Алқа мүшесінің (Министрдің) көмекшісі

ШУТОВА Елена Федоровна    –  Сауда саясаты департаменті тауарлар бөлімінің бастығы

ШУХНО Сергей Степанович – Интеграцияны дамыту департаменті директорының орынбасары

ЩЕКИН Дмитрий Александрович – Техникалық реттеу және аккредиттеу департаменті Дәрілік заттар мен медициналық бұйымдардың ортақ нарығын қалыптастыруды үйлестіру бөлімінің бастығы

ЩУР-ТРУХАНОВИЧ Лилия Васильевна – Құқық департаменті директорының орынбасары

ЮЛЕГИН Артем Александрович – Кәсіпкерлік қызметті дамыту департаменті кәсіпкерлікті адвокаттандыру бөлімінің бастығы

ЯРУЛЛИН Ленар Нафигуллович –  Монополияға қарсы реттеу департаменті көлік және коммуникация нарықтарын талдау және тергеп-тексерулер жүргізу бөлімі бастығының орынбасары.



Жоғары Еуразиялық экономикалық кеңес мүшелері:


АрменияРеспубликасынан	|	БеларусьРеспубликасынан	|	ҚазақстанРеспубликасынан	|	РесейФедерациясынан











