Жоғары Еуразиялық экономикалық кеңестің 2018 жылғы 6 желтоқсандағы № 28 шешімімен бекітілген "Еуразиялық экономикалық одақтың дамуына қосқан үлесі үшін" медалі туралы ереженің 3-тармағына сәйкес, Еуразиялық экономикалық одақтың дамуына айтарлықтай үлес қосқан Еуразиялық экономикалық одаққа мүше мемлекеттердің азаматтарын, сондай-ақ үшінші мемлекеттердің азаматтарын көтермелеу мақсатында Жоғары Еуразиялық экономикалық кеңес шешті:

Қосымшаға сәйкес тізім бойынша Еуразиялық экономикалық одаққа мүше мемлекеттердің азаматтары, сондай-ақ үшінші мемлекеттердің азаматтары "Еуразиялық экономикалық одақтың дамуына қосқан үлесі үшін" медалімен наградталсын.

Жоғары Еуразиялық экономикалық кеңес мүшелері:

Армения Республикасынан	|	Беларусь Республикасынан	|	Қазақстан Республикасынан	|	Қырғыз Республикасынан	|	Ресей Федерациясынан




	|	Жоғары Еуразиялықэкономикалық кеңестің2019 жылғы 29 мамырдағы№ 3 шешімінеҚОСЫМША

"Еуразиялық экономикалық одақтың дамуына қосқан үлесі үшін" медалімен наградталатын Еуразиялық экономикалық одаққа мүше мемлекеттер азаматтарының, сондай-ақ үшінші мемлекеттер азаматтарының ТІЗІМІ
Армения Республикасынан

АБГАРЯН Ара Гамлетович – Армения Республикасы Экономикалық даму және инвестициялар министрлігінің Зияткерлік меншік агенттігі мемлекеттік тізілім бөлімінің бастығы

АБГАРЯН Сатеник Смбатовна – Армения Республикасы Президентінің көмекшісі, Армения Республикасы Сыртқы істер министрлігінің Халықаралық шарттар және құқық департаментінің бастығы (2016-2019 жылдары)

АБОВЯН Ромелла Александровна – Армения Республикасы Денсаулық сақтау министрлігінің "Ауруларды бақылау және профилактикасы жөніндегі ұлттық орталық" мемлекеттік коммерциялық емес ұйымының жұқпалы емес аурулар және ауруханаішілік жұқпа эпидемиологиясы бөлімінің меңгерушісі

АБРААМЯН Мгер Гамлетович – Армения Республикасы Орталық банкінің қаржылық жүйені реттеу бөлімінің бастығы

АБРААМЯН Сергей Оникович – Армения Республикасы Қорғаныс министрлігінің Қорғаныс саясаты басқармасы бастығының орынбасары -халықаралық шарт-құқықтық қамтамасыз ету бөлімінің бастығы

АВАНЕСЯН Аваг Ваграмович – Армения Республикасы Экономикалық даму және инвестициялар министрінің орынбасары

АВЕТИСЯН Анаит Георгиевна – Армения Республикасы Қоғамдық қызметтер көрсетуді реттеу комиссиясының халықаралық ынтымақтастық бөлімінің бастығы

АГАДЖАНЯН Арман Робертович – Армения Республикасы Сыртқы істер министрлігінің Мемлекеттік протокол қызметі бастығының орынбасары

АГАДЖАНЯН Виолетта Владиславовна – Армения Республикасы Көлік, байланыс және ақпараттық технологиялар министрлігінің Сыртқы байланыстар мен бағдарламалар департаменті бастығының орынбасары

АГАРОНЯН Ева Робертовна – Армения Республикасы Сыртқы істер министрлігінің ТМД департаментінің екінші хатшысы (2013-2016 жылдары)

АЗИЗЯН Оганес Вагикович - Армения Республикасы вице-премьерінің кеңесшісі

АЛЕКСАНДРЯН Анаит Валиковна – Армения Республикасы Табиғатты қорғау министрлігінің қауіпті химиялық заттар мен қалдықтар саясаты бөлімінің бастығы

АЛЕКСАНЯН Андраник Гегамович – Армения Республикасы Сауда-өнеркәсіп палатасының атқарушы директоры

АМИРДЖАНЯН Левон Дмитриевич – Армения Республикасының Француз Республикасындағы Елшілігінің кеңесшісі, Сыртқы істер министрлігінің Құқықтық департаментінің бастығы (2009 -2016 жылдары)

АМИРХАНЯН Микаел Давидович – В. Я. Брюсов атындағы Ереван мемлекеттік тілдер және әлеуметтік ғылымдар университетінің орыс тілі мен мәдениеті орталығының жетекшісі

АНАНЯН Давид Санасарович – Армения Республикасы Мемлекеттік кірістер комитетінің төрағасы

АРУСТАМЯН Карен Васильевич – Армения Республикасы Аудиторлық палатасы әдіснама, талдау және халықаралық байланыстар басқармасының бастығы

АРУТЮНЯН Арман Месропович – Армения Республикасы Үкіметі жанындағы Армения Республикасының Қала құрылысы комитеті Халықаралық ынтымақтастық және құрылыс-инвестициялық бағдарламалар басқармасының бастығы

АРУТЮНЯН Армен Анатольевич – Армения Республикасы Ауыл шаруашылығы министрінің орынбасары (2013-2018 жылдары)

АРУТЮНЯН Роберт Хосровович – Армения Республикасы Сыртқы істер министрінің орынбасары (2016-2018 жылдары)

АСЕЯН Владимир Артакович – Армения Республикасы Қаржы министрлігінің Кіріс саясаты және әкімшілік ету әдіснамасы басқармасы бастығының орынбасары – кеден саясаты және Еуразиялық экономикалық одақты заңнамалық реттеу бөлімінің бастығы

БАБАЯН Альберт Артурович – Армения Республикасы Экономикалық даму және инвестициялар министрінің орынбасары

БАГРАМЯН Гарегин Каджикович – Армения Республикасы Қоғамдық қызметтер көрсетуді реттеу комиссиясының төрағасы

БАДАЛЯН Ани Мишаевна – Армения Республикасы Сыртқы істер министрлігінің ТМД елдерімен және құрылымдарымен ынтымақтастық департаментінің үшінші хатшысы

БАКУНЦ Нуне Григорьевна – Армения Республикасы Денсаулық сақтау министрлігінің "Ауруларды бақылау және профилактикасы жөніндегі ұлттық орталық" мемлекеттік коммерциялық емес ұйымы бас директорының орынбасары

ВАРДАНЯН Артур Рубенович – Армения Республикасы Қоғамдық қызметтер көрсетуді реттеу комиссиясының мүшесі

ВАРДАНЯН Наира Николаевна – Армения Республикасы Экономикалық даму және инвестициялар министрлігінің Сапа инфрақұрылымын дамыту басқармасы техникалық реттеу бөлімінің бас маманы

ВАРДАНЯН Тигран Степанович – Армения Республикасы Сыртқы істер министрлігі Халықаралық шарттар және құқық департаменті халықаралық шарттарды орындау және ішкімемлекеттік құқық бөлімі бастығының міндетін атқарушы

ГАБРИЕЛЯН Ваче Вазгенович – Армения Республикасының вице-премьері, Армения Республикасының Халықаралық экономикалық интеграция және реформалар министрі (2014-2018 жылдары)

ГАМБАРЯН Давид Рубенович – Армения Республикасы Сыртқы істер министрлігі Мемлекеттік протокол қызметі ресми сапарлар бөлімі бастығының міндетін атқарушы

ГЕВОНДЯН Армен Вачикович – Армения Республикасының Беларусь Республикасындағы Төтенше және Өкілетті Елшісі, Армения Республикасының Тәуелсіз Мемлекеттер Достастығының жарғылық және басқа органдары жанындағы Тұрақты өкілетті өкілі

ГЕВОРКЯН Давид Гургенович – Ереван мэриясы аппаратының Сыртқы байланыстар басқармасының бастығы

ГРИГОРЯН Ваагн Арменович – Армения Республикасы Орталық банкінің Ақша-кредит саясаты басқармасының бастығы

ГРИГОРЯН Рафаел Ленсерович – Армения Республикасы Мемлекеттік кірістер комитетінің Ақпараттық технологиялар басқармасы талдау және тәуекелдерді басқару бөлімінің бастығы

ГУКАСЯН Андраник Гришаевич – "Экенг" жабық акционерлік қоғамы директорының орынбасары

ДАВТЯН Ирина Варшамовна – Армения Республикасы Аумақтық басқару және даму министрлігі Көші-қон қызметі бастығының орынбасары

ДЕМИРХАНЯН Борис Борисович – Армения Республикасы Көлік, байланыс және ақпараттық технологиялар министрінің орынбасары

ЕГАНЯН Армен Жораевич – Армения Республикасы Экономикалық даму және инвестициялар министрлігінің Өнеркәсіптік саясат басқармасының бастығы

ЕГИАЗАРЯН Мариам Мурадовна – Армения Республикасы Орталық банкінің Қаржы жүйесін реттеу басқармасы банк жүйесін реттеу бөлімінің бастығы

ЗАКАРЯН Жанна Рубиковна – Армения Республикасы Экономикалық даму және инвестициялар министрлігінің Сапа инфрақұрылымын дамыту басқармасының бастығы

ИВАНОВ Карен Вячеславович – Армения Республикасы Сауда-өнеркәсіп палатасы ТМД мәселелері бөлімінің кеңесшісі, "Ивенорталық" жауапкершілігі шектеулі қоғамының бас директоры

КАЗАРЯН Арсен Владимирович – Армения Өнеркәсіпшілері мен кәсіпкерлері одағының президенті

КАЛТАХЧАН Павел Сергеевич – Армения Республикасы Экономикалық бәсекелестікті қорғау мемлекеттік комиссиясы төрағасының орынбасары

КАРАПЕТЯН Наира Куйбышевна – Армения Республикасы Экономикалық даму және инвестициялар министрлігінің ЕАЭО және сыртқы сауда басқармасының бастығы

КАРАЯН Сурен Гамлетович – Армения Республикасының Экономикалық даму және инвестициялар министрі (2016-2018 жылдары)

КОЧАРЯН Виген Владимирович – Армения Республикасы Әділет министрінің орынбасары

КОЧАРЯН Шаварш Микаелович – Армения Республикасы Сыртқы істер министрінің орынбасары

КУСИКЯН Лиана Владимировна – Армения Республикасы Мемлекеттік кірістер комитетінің Ақпараттық технологиялар басқармасы жобаларды іске асыру бөлімінің бас кедендік инспекторы

ЛАЛАЯН Ваагн Степанович – Армения Республикасы Экономикалық даму және инвестициялар министрлігінің Инвестициялық саясат басқармасының бастығы

МАКАРЯН Гагик Арменакович – Армения Республикалық жұмыс берушілер одағының президенті

МАНАСЕРЯН Татул Норайрович – Ереван мемлекеттік университетінің экономика және басқару факультетінің профессоры

МАНУКЯН Лариса Владимировна – Армения Республикасы Үкіметі жанындағы Жылжымайтын мүлік кадастры комитеті бірінші бөлімінің бастығы

МАРГАРЯН Гаянэ Камоевна – Армения Республикасы Экономикалық даму және инвестициялар министрлігінің Сапа инфрақұрылымын дамыту басқармасы техникалық реттеу бөлімінің бастығы

МАРКОСЯН Мгер Вардгесович – "Ереван байланыс құралдары ғылыми-зерттеу институты" жабық акционерлік қоғамының директоры

МАРТИРОСЯН Мгер Ваагнович – Армения Республикасы Мемлекеттік кірістер комитетінің Кедендік бақылау басқармасы бастығының орынбасары

МАТЕВОСЯН Овсеп Мартикович – Армения Республикасы Сыртқы істер министрлігінің ТМД елдерімен және құрылымдарымен ынтымақтастық департаментінің атташесі

МЕЛКОНЯН Анна Гамлетовна – Армения Республикасы "Аккредиттеу жөніндегі ұлттық орган" мемлекеттік коммерциялық емес ұйымы директорының міндетін атқарушы

МЕЛКОНЯН Ирэн Робертовна – Армения Республикасы Ауыл шаруашылығы министрлігінің Сыртқы байланыстар басқармасы халықаралық ұйымдармен ынтымақтастық бөлімінің бастығы

МЕЛКУМЯН Микаел Сергеевич – Армения Республикасы Ұлттық жиналысының депутаты

МКРТЧЯН Мартин Рубикович – Армения Республикасы Үкіметі жанындағы Денсаулық сақтау және еңбек инспекциялық органы "Ширак" әуежайының шекаралық медициналық-санитариялық пунктінің эпидемиологы

МОВСИСЯН Камо Андраникович – Армения Республикасы "Ұлттық метрология институты" жабық акционерлік қоғамы бас директорының бас кеңесшісі

МОВСИСЯН Лилит Самвеловна – Армения Республикасы Мемлекеттік кірістер комитетінің Әкімшілік ету әдіснамасы, рәсімдер және қызмет ету басқармасы бастығының орынбасары

МОВСИСЯН Эмма Александровна – Армения Республикасы Экономикалық даму және инвестициялар министрлігінің Еуразиялық экономикалық одақ және сыртқы сауда басқармасы бастығының орынбасары

МХИТАРЯН Ани Товиковна – Армения Республикасы Көлік, байланыс және ақпараттық технологиялар министрлігінің Ақпараттық, жоғары технологиялар және цифрландыру департаментінің бас маманы

НРАНЯН Ара Рудикович – Еуразиялық экономикалық комиссия Алқасының мүшесі (Министр) (2015-2016 жылдары)

ОВСЕПЯН Агаси Айвазович – Армения Республикасы Үкіметі жанындағы Армения Республикасының Қала құрылысы комитеті Құрылыс және ғылыми-техникалық нормалау басқармасы ғылыми-техникалық саясат бөлімінің бастығы

ОГАНЕСЯН Макич Аршакович – Армения Республикасы Энергетикалық инфрақұрылымдар және табиғи ресурстар министрлігінің Сыртқы байланыстар басқармасы Еуразиялық экономикалық одақ бөлімінің бастығы

ПАРАНЯН Самвел Сергеевич – Армения Республикасы Экономикалық даму және инвестициялар министрлігінің Өнеркәсіптік саясат басқармасының бас маманы

ПАШАЯН Микаел Мушегович – Армения Республикасы Мемлекеттік кірістер комитеті төрағасының орынбасары

ПОГОСЯН Арман Вачаганович – Армения Республикасы Қаржы министрінің орынбасары

ПОГОСЯН Рафаел Вазгенович – Армения Республикасы Аумақтық басқару және даму министрлігі Халықаралық және шекара маңындағы ынтымақтастық департаментінің жетекші маманы

ПОЛАДЯН Карине Аршавировна – Армения Республикасы Экономикалық бәсекелестікті қорғау мемлекеттік комиссиясының мүшесі (2014-2019 жылдары)

САИЯН Смбат Ервандович – Армения Республикасы Еңбек және әлеуметтік мәселелер министрінің орынбасары

САРОЯН Лилит Левоновна – Армения Республикасы Аумақтық басқару және даму министрлігі халықаралық және шекара маңындағы ынтымақтастық бөлімінің бастығы

САФАРЯН Арам Виленович – Ереван мемлекеттік университеті халықаралық қатынастар кафедрасының доценті, "Интеграция және даму" жауапкершілігі шектеулі қоғамының төрағасы, Еуразиялық сарапшылық клубтың үйлестірушісі

САФЯН Анаит Павловна – Армения Республикасы Статистика жөніндегі мемлекеттік кеңесінің мүшесі, Армения Республикасының Статистика комитеті

СЕПЯН Спартак Генрихович – Армения Республикасы Полициясының "Жол полициясы" қызметі есепке алу-емтихандау және көлік құралдарының техникалық сараптамасы бөлімінің бастығы

СУКИАСЯН Эдуард Агасиевич – Армения Республикасы Аудиторлық палатасы әдіснама, талдау және халықаралық байланыстар басқармасының бас маманы

ТАВАДЯН Ашот Агасиевич – Армян мемлекеттік экономикалық университеті экономикалық-математикалық әдістер кафедрасының меңгерушісі, "Экономикалық зерттеулер орталығы" қоғамдық ұйымының жетекшісі

ТАМРАЗЯН Владимир Оганесович – Армения Республикасы Үкіметі жанындағы Нарықты қадағалау жөніндегі инспекциялық органның техникалық регламенттерде белгіленген талаптарды сақтауды және қымбат бағалы металдарды қадағалау басқармасының бастығы

ТАРАСЯН Эмиль Самвелович – Армения Республикасы Президенті Апаратының басшысы

ТЕРТЕРЯН Ваче Багратович – Армения Республикасы Аумақтық басқару және даму министрінің бірінші орынбасары

ТОПЧЯН Акоп Вартанович – "Академик Э. Габриелян атындағы дәрілер мен медициналық технологияларды сараптау ғылыми орталығы" жабық түрдегі акционерлік қоғамы директорлар кеңесінің төрағасы, Мхтиар Гераци атындағы Ереван мемлекеттік медицина университетінің дәрілер технологиясы кафедрасының меңгерушісі

ТУМЯН Лусине Вачеевна – Армения Республикасы Премьер-министрі Аппараты Халықаралық экономикалық интеграция департаментінің бастығы

ФАРМАНЯН Левон Робертович – Армения Республикасы Қаржы министрлігінің Халықаралық ынтымақтастық басқармасы бастығының орынбасары – Еуразиялық экономикалық одақпен және Еуразиялық экономикалық одаққа мүше мемлекеттермен ынтымақтастық бөлімінің бастығы

ЧАХАЛЯН Вардуи Ашотовна – Армения Республикасы Көлік, байланыс және ақпараттық технологиялар министрлігінің Көлік департаменті техникалық саясат бөлімінің жетекші маманы

ЧИЛИНГАРЯН Аарон Арутюнович – әріптес, "Би-Ди-О" акаунтинг салық бөлімінің бастығы, такс ЭНД Лигал

ШИРВАНЯН Ашхен Юрьевна – Армения Республикасы Ауыл шаруашылығы министрлігінің тамақ өнімдерінің қауіпсіздігі бөлімінің бастығы

ШМАВОНЯН Хачик Саргисович – Армения Республикасы Төтенше жағдайлар министрлігінің техникалық апаттар бөлімінің аға маманы

ЯРАЛОВА Армине Вардановна – Армения Республикасы Орталық банкінің Ақша-кредит саясаты басқармасы сыртқы секторды талдау және болжау бөлімінің макроэкономисі

Беларусь Республикасынан

АРТЕМЬЕВ Алексей Алексеевич – Беларусь Республикасы Мемлекеттік кеден комитеті Кедендік бақылауды ұйымдастыру бас басқармасы бастығының орынбасары

БАРТАШЕВИЧ Дмитрий Петрович – Беларусь Республикасы Мемлекеттік стандарттау комитеті төрағасының орынбасары

БАСАЛЫГА Александр Евгеньевич – Беларусь Республикасы Әділет министрлігі Халықаралық ынтымақтастық басқармасы бастығының орынбасары – халықаралық-құқық бөлімінің бастығы

БОГДАНКЕВИЧ Ольга Анатольевна – Беларусь Республикасы Экономика министрлігі Экономикалық интеграция бас басқармасы Еуразиялық экономикалық комиссиямен өзара іс-қимыл басқармасының консультанты

БОГДЕВИЧ Александр Викторович – Беларусь Республикасы Мемлекеттік кеден комитеті төрағасының орынбасары

ВИШНЕВСКИЙ Олег Валентинович – Беларусь Республикасы Экономика министрлігі Экономикалық интеграция бас басқармасы Еуразиялық экономикалық комиссиямен өзара іс-қимыл басқармасының консультанты

ВЫСОЦКАЯ Кристина Николаевна – Беларусь Республикасы Мемлекеттік стандарттау комитеті төрағасының көмекшісі

ГЕРУС Владимир Анатольевич – Беларусь Республикасының Ресей Федерациясындағы Елшілігінің кеңесшісі

ГОЛОТА Елена Михайловна – Беларусь Республикасы Экономика министрлігінің Экономикалық интеграция бас басқармасы нарықтар интеграциясы басқармасының консультанты

ГОРЕЛИК Дмитрий Николаевич – Беларусь Республикасы Министрлер Кеңесі Аппараты Халықаралық ынтымақтастық және сауда бас басқармасының бастығы

ГРИШКЕВИЧ Оксана Александровна – Беларусь Республикасы Мемлекеттік стандарттау комитеті Техникалық нормалау және стандарттау басқармасының бастығы

ГУРЬЯНОВ Александр Евгеньевич – Беларусь Республикасының Италия Республикасындағы Төтенше және Өкілетті Елшісі, Беларусь Республикасының Біріккен Ұлттар Ұйымы Азық-түлік және ауыл шаруашылығы ұйымы жанындағы Тұрақты өкілі, қоса атқаруы бойынша Беларусь Республикасының Мальта Республикасындағы Төтенше және Өкілетті Елшісі

ДАЛИДОВИЧ Сергей Викторович – Беларусь Республикасы Мемлекеттік кеден комитеті Кедендік операцияларды автоматтандыру және жедел бақылау бас басқармасы кедендік ақпараттың жедел мониторингі және бақылау бөлімі бастығының орынбасары

ДРОЗД Людмила Владимировна – Беларусь Республикасы Мемлекеттік кеден комитеті Тарифтік реттеу және кедендік төлемдер бас басқармасы кедендік міндеттемелердің орындалуын бақылау әдіснамасы бөлімінің бастығы

ДУБИНА Сергей Станиславович – Беларусь Республикасы Көлік және коммуникациялар министрлігі Автомобиль және қалалық жолаушылар көлігі басқармасының бастығы

ДУБРОВСКАЯ Татьяна Валерьевна – Беларусь Республикасы Мемлекеттік кеден комитеті Тарифтік реттеу және кедендік төлемдер бас басқармасы бастығының орынбасары

ДЫНОВСКАЯ Анна Сергеевна – Беларусь Республикасы Әділет министрлігі Халықаралық ынтымақтастық басқармасы халықаралық-құқық бөлімі бастығының орынбасары

ЖЕГУЛО Ольга Владимировна – Беларусь Республикасы Экономика министрлігі Экономикалық интеграция бас басқармасы Еуразиялық экономикалық комиссиямен өзара іс-қимыл басқармасының консультанты

ЗИНОВСКИЙ Владимир Иванович – Беларусь Республикасының Экономика министрі (2014-2018 жылдары)

ИВАНОВ Юрий Евгеньевич – Беларусь Республикасы Экономика министрлігі Өнеркәсіп, көлік және байланыс бас басқармасының тұтыну тауарлары өндірісі экономикасы бөлімінің бастығы, өнеркәсіп экономикасы бас басқармасының өнеркәсіпті дамыту басқармасының бастығы (2014-2017 жылдары)

КАЛОШКИНА Елена Эдуардовна – Беларусь Республикасының Чех Республикасындағы Елшілігінің кеңесшісі

КИЙКО Дмитрий Николаевич – Беларусь Республикасы Қаржы министрінің орынбасары

КОВАЛҢНОК Дмитрий Витальевич – Беларусь Республикасы Мемлекеттік кеден комитеті Құқықтық басқармасы халықаралық ынтымақтастық бөлімінің бас инспекторы, Беларусь Республикасы Мемлекеттік кеден комитетінің Беларусь Республикасының Қытай Халық Республикасындағы Елшілігіндегі ресми өкілі

КОНСТАНТИНОВИЧ Оксана Валерьевна – Беларусь Республикасы Монополияға қарсы реттеу және сауда министрлігі Халықаралық ынтымақтастық және тарифтік емес реттеу шараларын қолдану басқармасының бастығы

КОПАНЕВА Елена Николаевна – Беларусь Республикасы Сыртқы істер министрлігі Ресей, ТМД елдері және Еуразиялық интеграция бас басқармасының Еуразиялық интеграция басқармасы бастығының орынбасары

КОСТЫК Анатолий Николаевич – Беларусь Республикасы Министрлер Кеңесі Аппараты Халықаралық ынтымақтастық және сауда бас басқармасы бастығының орынбасары – сыртқы экономикалық қызмет басқармасының бастығы

КРАСНОВ Игорь Леопольдович – Беларусь Республикасы Көлік және коммуникациялар министрлігі Даму бағдарламалары және халықаралық ынтымақтастық басқармасы халықаралық ынтымақтастық бөлімінің бастығы

ЛЯХНОВИЧ Алексей Алексеевич – Беларусь Республикасы Көлік және коммуникациялар министрінің бірінші орынбасары

МАЦЕВИЛО Алексей Евгеньевич – Беларусь Республикасы Экономика министрлігі Экономикалық интеграция бас басқармасының бастығы

МЕЛЬГУЙ Жанна Владимировна – Беларусь Республикасы Экономика министрлігі Өнеркәсіп экономикасы бас басқармасының бастығы

МИНИЧ Дина Николаевна – Беларусь Республикасы Қаржы министрлігінің Халықаралық қаржы қатынастары бас басқармасы мемлекетаралық интеграция басқармасының консультанты

МИХНЕВИЧ Александр Юрьевич – Беларусь Республикасының Бельгия Корольдігіндегі Төтенше және Өкілетті Елшісі, Беларусь Республикасының Еуропалық одақ және Еуропалық атом энергиясы жөніндегі қоғамдастық жанындағы Тұрақты өкілі, қоса атқаруы бойынша Беларусь Республикасының Солтүстік Атлант шарты ұйымы жанындағы Тұрақты өкілі, қоса атқаруы бойынша Беларусь Республикасының Люксембург Ұлы Герцогтігіндегі Төтенше және Өкілетті Елшісі

НАЗАРЕНКО Виктор Владимирович – Беларусь Республикасы Мемлекеттік стандарттау комитетінің төрағасы (2012-2018 жылдары)

НЕДОСТУП Андрей Владимирович – Беларусь Республикасы Қаржы министрлігі Салық саясаты және бюджет кірістері бас басқармасы салық саясаты басқармасы бастығының орынбасары - жанама салық алу, мүліктік салықтар және өзге де төлемдер бөлімінің бастығы

НЕХАЙЧИК Андрей Викторович – Еуразиялық экономикалық комиссияның Көлік және инфрақұрылым департаменті көлік саясаты бөлімінің кеңесшісі

ОРЛОВСКИЙ Владимир Николаевич – Беларусь Республикасы Мемлекеттік кеден комитеті төрағасының бірінші орынбасары

ПАНАСЮК Сергей Константинович – Беларусь Республикасының Ресей Федерациясындағы Елшілігінің кеңесшісі

ПАРКОВСКАЯ Наталия Федоровна – Беларусь Республикасы Мемлекеттік стандарттау комитеті Техникалық нормалау және стандарттау басқармасы бастығының орынбасары

ПЕТРОВСКИЙ Кирилл Геннадьевич – Беларусь Республикасының Еуропалық одақ жанындағы Тұрақты өкілдігінің, Беларусь Республикасының Бельгия Корольдігіндегі және Люксембург Ұлы Герцогтігіндегі Елшілігінің кеңесшісі

ПЛАНИН Андрей Александрович – Беларусь Республикасы Мемлекеттік кеден комитеті Кедендік бақылауды ұйымдастыру бас басқармасы кедендік бақылауды ұйымдастыру және технологиялардың тиімділігін талдау бөлімінің бастығы

ПОЛУДЕНЬ Сергей Анатольевич – – Беларусь Республикасы Мемлекеттік кеден комитеті төрағасының орынбасары

ПЫТАЛЕВ Александр Андреевич – Беларусь Республикасы Сыртқы істер министрлігі Шарт-құқық бас басқармасының халықаралық экономикалық құқық басқармасы бастығының орынбасары

РОМАНОВСКИЙ Алексей Валерьевич – Беларусь Республикасы Экономика министрлігі Экономикалық интеграция бас басқармасы бастығының орынбасары - Еуразиялық экономикалық комиссиямен өзара іс-қимыл басқармасының бастығы

РЫЖОВ Константин Степанович – Беларусь Республикасы Мемлекеттік кеден комитеті Контрабандаға қарсы күресті ұйымдастыру және посткедендік бақылау бас басқармасы посткедендік бақылауды ұйымдастыру бөлімі бастығының орынбасары

САДОВСКАЯ Наталья Леоновна – Беларусь Республикасы Сыртқы істер министрлігі Шарт-құқық бас басқармасы бастығының орынбасары - халықаралық экономикалық құқық басқармасының бастығы

САМОСУЕВ Алексей Иванович – Беларусь Республикасының Финляндия Республикасындағы Төтенше және Өкілетті Елшісі

СВИДЕРСКИЙ Геннадий Брониславович – Беларусь Республикасы Өнеркәсіп министрінің бірінші орынбасары

СЕНЬКО Юрий Алексеевич – Беларусь Республикасы Мемлекеттік кеден комитетінің төрағасы

СИЛКОВ Сергей Викторович – Беларусь Республикасының Ресей Федерациясындағы Елшілігінің кеңесші уәкілі

СКУРАНОВИЧ Анжела Леонидовна – Беларусь Республикасы Денсаулық сақтау министрлігінің "Республикалық гигиена, эпидемиология және қоғамдық денсаулық орталығы" мемлекеттік мекемесінің бас дәрігері

СМАРГУН Елена Ростиславовна – Беларусь Республикасы Қаржы министрлігінің Халықаралық қаржы қатынастары бас басқармасы бастығының орынбасары - мемлекетаралық интеграция басқармасының бастығы

СОБОЛЕВ Роман Валерьевич – Беларусь Республикасы Сыртқы істер министрлігі Сыртқы экономикалық қызмет департаменті директорының орынбасары, директоры (2014-2019 жылдары)

СУЗЬКО Екатерина Владимировна – Беларусь Республикасы Экономика министрлігінің Макроэкономикалық талдау және болжау бас басқармасы макроэкономикалық саясат басқармасының консультанты

ТАТАРИЦКИЙ Валентин Болеславович – Беларусь Республикасы Мемлекеттік стандарттау комитетінің төрағасы

ТУСКАЛЬ Дмитрий Валерьевич – Беларусь Республикасы Әділет министрлігі Халықаралық ынтымақтастық басқармасы халықаралық-құқық бөлімінің консультанты

ТУШИНСКИЙ Игорь Геронинович – Беларусь Республикасы Әділет министрінің орынбасары

УСОШИНА Елена Петровна – Беларусь Республикасы Ауыл шаруашылығы және азық-түлік министрлігі Сыртқы экономикалық қызмет бас басқармасы сыртқы сауда басқармасының сыртқы сауда, ДСҰ-мен және ЕЭК-пен өзара іс-қимыл бөлімінің консультанты

ФОМЧЕНКО Дмитрий Анатольевич – Беларусь Республикасының БҰҰ Бөлімшесі және Женевадағы басқа да халықаралық ұйымдар жанындағы Тұрақты өкілінің орынбасары

ХАТКЕВИЧ Елена Николаевна – Беларусь Республикасы Экономика министрлігінің Экономикалық интеграция бас басқармасы Еуразиялық экономикалық комиссиямен өзара іс-қимыл басқармасы бастығының орынбасары

ЧЕБОТАРЬ Юрий Адамович – Беларусь Республикасы Экономика министрінің орынбасары

ЧЕРНАЯ Татьяна Викторовна – Беларусь Республикасы Экономика министрлігі Өнеркәсіп экономикасы бас басқармасы өнеркәсіпті дамыту басқармасы бастығының орынбасары

ШАТОХИНА Екатерина Владимировна – Беларусь Республикасы Сыртқы істер министрлігі Сыртқы экономикалық қызмет департаменті сыртқы сауда басқармасының сыртқы сауданы реттеу бөлімінің аға кеңесшісі

ШОЛОДОНОВ Игорь Васильевич – Беларусь Республикасының Қазақстан Республикасындағы Елшілігінің кеңесші уәкілі

ШУРПАК Анна Ивановна – Беларусь Республикасы Экономика министрлігі Мемлекеттік бағдарламалардың әдіснамасы және үйлестіру бас басқармасының мемлекеттік бағдарламалар басқармасы бастығының орынбасары

ЯНОВЕЦ Надежда Витальевна – Беларусь Республикасы Қаржы министрлігінің Халықаралық қаржы қатынастары бас басқармасы мемлекетаралық интеграция басқармасының консультанты

Қазақстан Республикасынан

АБАЕВ Дәурен Әскербекұлы – Қазақстан Республикасы Ақпарат және қоғамдық даму министрі

ӘБДІБАЕВ Жарқын Болатұлы – Қазақстан Республикасы Ұлттық экономика министрлігінің бас сарапшысы

ӘБДІКӘРІМОВ Аслан Жаңабергенұлы – Қазақстан Республикасы Қаржы министрлігі Халықаралық қаржы қатынастары департаменті Еуразиялық интеграция басқармасының басшысы

ӘБДІҚАДЫРОВ Дәурен Садықұлы – Қазақстан Республикасының Тұңғыш Президенті – Елбасы Кеңсесінің сарапшысы

ӘБДУӘЛИ Дарын Әбдуәлиұлы – Қазақстан Республикасы Ұлттық экономика министрлігі Салық және кеден саясаты департаменті директорының орынбасары

ӘБДУӘЛИЕВА Меруерт Құлмұратқызы – Қазақстан Республикасы Ұлттық экономика министрлігі Халықаралық экономикалық интеграция департаментінің директоры (2017-2019 жылдары)

ӘДІЛХАНОВ Әкежан Атабекұлы – Қазақстан Республикасы Әділет министрлігі Халықаралық экономикалық интеграция бойынша жобаларды сараптау департаментінің директоры

ӘЗІМОВА Эльвира Әбілхасымқызы – Қазақстан Республикасы Әділет министрінің орынбасары

АЙТАҚОВ Ержан Тюлюканович – Қазақстан Республикасы Қорғаныс министрлігі Әскери-техникалық саясат департаменті бастығының орынбасары – қорғаныс тапсырысы, әскери-техникалық ынтымақтастық және сарапшылық бақылау басқармасының бастығы

АҚЫШЕВ Данияр Талғатұлы – Қазақстан Республикасы Тұңғыш Президенті – Елбасы көмекшісі

АҚПАН Бақшагүл Берікқызы – Қазақстан Республикасы Президенті Әкімшілігі Қазақстан Республикасы Президенті протоколының сектор меңгерушісі

АЛДАБЕРГЕНОВ Нұрлан Шәдібекұлы – Қазақстан Республикасы Ұлттық экономика министрлігінің Жауапты хатшысы

ӘЛИЕВА Ақ-бала Тағаймұратқызы – Қазақстан Республикасы Қаржы министрлігі Бухгалтерлік есеп, аудит және бағалау әдіснамасы департаменті директорының орынбасары

ӘЛІМБЕТОВА Әлия Назымбекқызы – Еуразиялық экономикалық комиссияның Кедендік-тарифтік реттеу және тарифтік емес реттеу департаменті директорының орынбасары

АМРИН Азамат Кеменгерұлы – Қазақстан Республикасы Ұлттық экономика министрлігі Салық және кеден саясаты департаментінің директоры

АМРИН Ғосман Кәрімұлы – Қазақстан Республикасы Қаржы министрлігі Мемлекеттік кірістер комитеті төрағасының орынбасары (2014-2019 жылдары)

АСАВБАЕВ Әсет Асанұлы –Қазақстан жолшылары қауымдастығының президенті, "ҚазАвтоЖол" Ұлттық компаниясы" акционерлік қоғамының тәуелсіз директоры

АСАУТАЕВ Бақтияр Берікұлы – Қазақстан Республикасы Ұлттық экономика министрлігі Халықаралық экономикалық интеграция департаменті директорының орынбасары

АСҚАРҰЛЫ Азамат – Қазақстан Республикасы Премьер-Министрі Бірінші орынбасарының кеңесшісі

АТАМҚҰЛОВ Бейбіт Бәкірұлы – Қазақстан Республикасының Сыртқы істер министрі

АУСАБАЕВ Олжас Алмасханұлы – "Атамекен" Қазақстан Республикасы кәсіпкерлерінің ұлттық палатасы Агроөнеркәсіптік кешен және тамақ өнеркәсібі департаментінің бірінші санаттағы сарапшысы

АХМЕТОВ Әнуар Жасұланұлы – Қазақстан Республикасы Президенті Әкімшілігі сыртқы саясат орталығының сектор меңгерушісі

АХМЕТОВ Даниал Кенжетайұлы – Еуразиялық экономикалық комиссияның Энергетика және инфрақұрылым жөніндегі Алқа мүшесі (2012-2014 жылдары)

АХМЕТОВ Дархан Тілекұлы – Қазақстан Республикасы Энергетика министрлігі Электр энергетикасы саласында мемлекеттік саясатты іске асыру департаменті электр энергетикасын және интеграцияны дамыту басқармасының басшысы

БАЕДІЛОВ Қанат Ескендірұлы – Қазақстан Республикасының Қаржы вице-министрі

БАИТОВ Қанат Құрмашұлы – Қазақстан Республикасы Инвестициялар және даму министрлігі Индустриялық даму және өнеркәсіптік қауіпсіздік комитетінің төрағасы

БАЙҒОЖИНА Айгүл Мырзатайқызы – Қазақстан Республикасы Қаржы министрлігі Қазынашылық комитеті төрағасының орынбасары

БАЙҚАДАМОВА Уасиля Төлеуқызы – Қазақстан Республикасы Ұлттық экономика министрлігі Сыртқы сауда қызметін дамыту департаменті директорының орынбасары

БАЙМАҒАНБЕТОВА Айжан Болатқызы – Қазақстан Республикасы Ұлттық экономика министрлігі жанындағы "Сауда саясатын дамыту орталығы" акционерлік қоғамының тауарлардың нарыққа түсуін талдау секторының бас сарапшысы

БАЙМЕНОВ Қайсар Нұржанұлы – Қазақстан Республикасы Қаржы министрлігі Халықаралық қаржы қатынастары департаментінің Еуразиялық интеграция басқармасының бас сарапшысы

БАҚЫТБЕКҚЫЗЫ Дария – Еуразиялық экономикалық комиссияның Ішкі нарықты қорғау департаменті директорының орынбасары

БАЛЫҚБАЕВ Қайрат Такирұлы – Қазақстан Республикасы Ақпарат және коммуникациялар вице-министрі (2017-2018 жылдары)

БЕЙСЕКЕЕВА Индира Жомартқызы – Қазақстан Республикасы Ұлттық экономика министрлігі Халықаралық экономикалық интеграция департаментінің Бірыңғай экономикалық кеңістікті қалыптастыру мәселелері басқармасының басшысы

БЕКІШЕВ Әсет Рысқалиұлы – Қазақстан Республикасы Ұлттық экономика министрлігі Салық және кеден саясаты департаменті кеден саясаты басқармасының бас сарапшысы

БЕКТҰРОВА Арман Тұрсынқызы – Қазақстан Республикасы Қаржы министрлігі Бухгалтерлік есеп, аудит және бағалау әдіснамасы департаментінің директоры

БЕКШИН Жандарбек Мұхтарұлы – Қазақстан Республикасы Денсаулық сақтау министрлігі Қоғамдық денсаулық сақтау комитетінің төрағасы

БЕЛГІБАЕВ Бауыржан Қуанышұлы – Жобалық басқаруды талдамалық және әдіснамалық сүйемелдеу орталығы директорының орынбасары

БЕСКЕМПІРОВ Олжас Серікжанұлы – Қазақстан Республикасы Президенті Әкімшілігі әлеуметтік-экономикалық мониторинг бөлімінің консультанты

БИСЕМБАЕВ Абай Айдарханұлы – Қазақстан Республикасының Тұңғыш Президенті – Елбасының көмекшісі - Қазақстан Республикасы Президенті Іс басқарушысының бірінші орынбасары

БОЗЫМБАЕВ Қанат Алдабергенұлы – Қазақстан Республикасының Энергетика министрі

БІРЕКЕШЕВ Серікқали Аманғалиұлы – "ҚазТрансГаз" акционерлік қоғамы бас директорының техникалық саясат жөніндегі орынбасары

ГАЛИЕВА Зухра Фархадовна – Қазақстан Республикасы Әділет министрлігі Халықаралық экономикалық интеграция бойынша жобаларды сараптау департаменті экономика, қаржы және сауда саласындағы жобаларды сараптау басқармасының басшысы

ДЕҢГЕЛБАЕВА Саяжан Бақытқызы – Қазақстан Республикасы Премьер-Министрі Кеңсесі Ақпараттық-талдау орталығының бас сарапшысы

ДОСАЕВА Жанар Рысбайқызы – Қазақстан Республикасы Мәдениет және спорт министрлігі Талдау және стратегиялық жоспарлау департаментінің директоры

ДОСМАҒАМБЕТОВ Ғарифолла Шайзадаұлы – Қазақстан Республикасы Қаржы министрлігі Мемлекеттік кірістер комитетінің Атырау облысы бойынша Мемлекеттік кірістер департаменті басшысының орынбасары

ДОСМҰХАМБЕТОВА Балжан Ибатқызы –"KAZAKH INVEST" Ұлттық компаниясы" акционерлік қоғамы корпоративтік хатшы қызметінің жобалық менеджері

ДОСЫМОВ Данияр Нұржанұлы – Қазақстан Республикасы Ұлттық экономика министрлігі Халықаралық экономикалық интеграция департаментінің Кеден одағы және ЕурАзЭҚ жұмыс істеуінің мәселелері басқармасының басшысы

ЕГЕМБЕРДИЕВА Әсел Ерікқызы – Қазақстан Республикасы Ұлттық экономика министрлігі жанындағы "Сауда саясатын дамыту орталығы" акционерлік қоғамы ЕАЭО жобаларының басшысы

ЕСЕМБАЕВ Айдар Маратұлы – Қазақстан Республикасы Ұлттық экономика министрлігі Табиғи монополияларды реттеу, бәсекелестікті қорғау және тұтынушылар құқықтары комитеті Экономикалық интеграция басқармасының басшысы

ЖАҚСЫЛЫҚОВ Бауыржан Нұртайұлы – Қазақстан Республикасы Энергетика министрлігі Мұнай өнеркәсібін дамыту департаменті еңбек және әлеуметтік мәселелер басқармасының басшысы

ЖАҚСЫЛЫҚОВ Тимур Мекешұлы – Еуразиялық экономикалық комиссияның Экономика және қаржы саясаты жөніндегі Алқа мүшесі (Министр)

ЖАҚЫПОВА Светлана Қабыкенқызы – – Қазақстан Республикасының Еңбек және халықты әлеуметтік қорғау вице-министрі

ЖАМАУБАЕВ Ерұлан Кенжебекұлы – Қазақстан Республикасы Қаржы министрлігінің Жауапты хатшысы

ЖАМБЫЛОВ Ержан Диасұлы – Қазақстан Республикасы Премьер-Министрі Кеңсесі экономика бөлімі меңгерушісінің орынбасары

ЖАПАРҚҰЛОВ Нұржан Бақытұлы – Қазақстан Республикасы Индустрия және инфрақұрылымдық даму министрлігінің Халықаралық экономикалық интеграция департаменті өнеркәсіптік саясат басқармасының басшысы

ЖИЕНБАЕВ Ержан Нұрланұлы – Қазақстан Республикасы Премьер-Министрі Кеңсесі заң бөлімінің меңгерушісі

ЖОЛДАСБАЕВ Олжас Сансызбайұлы – Қазақстан Республикасы Премьер-Министрі Бірінші орынбасарының - Қазақстан Республикасы Қаржы министрінің кеңесшісі

ЖҰМАБЕКОВ Хамит Сұлтанұлы – Қазақстан Республикасы Қаржы министрлігі Халықаралық қаржы қатынастары департаменті Еуразиялық интеграция басқармасының бас сарапшысы

ЖҰМАДІЛОВА Мәдина Асхатқызы – Қазақстан Республикасы Президенті Әкімшілігі Қазақстан Республикасы Президенті протоколының сектор меңгерушісі

ЖҰМАНҒАРИН Серік Мақашұлы – Еуразиялық экономикалық комиссияның Бәсекелестік және монополияға қарсы реттеу жөніндегі Алқа мүшесі (Министр)

ЖҮНІСОВА Дана Бейсенқызы – Қазақстан Республикасы Премьер-Министрінің кеңесшісі

ЗАБЕКОВ Азамат Төлешұлы – Қазақстан Республикасы Ауыл шаруашылығы министрлігі Ветеринариялық бақылау және қадағалау комитетінің Басқарма басшысы

ЗӘУІРБЕКОВА Торғын Сапарғалиқызы – "Сауда саясатын дамыту орталығы" акционерлік қоғамы агроөнеркәсіптік кешен секторының бас сарапшысы

ЗЕКЕНОВА Айжан Жақсылыққызы – Қазақстан Республикасы Ұлттық экономика министрлігі Халықаралық экономикалық интеграция департаментінің Бірыңғай экономикалық кеңістікті қалыптастыру мәселелері басқармасының басшысы

ЫБЫРАЙ Талғат Қарекеұлы – Қазақстан Республикасының Германия Федеративтік Республикасындағы Елшілігінің кеңесшісі

ЫБЫРАЙЫМ Әлібек Бекенұлы – Қазақстан Республикасы Президенті Әкімшілігі әлеуметтік-экономикалық мониторинг бөлімінің сектор меңгерушісі

ІЗТЕЛЕУОВ Ержан Сергейұлы – Қазақстан Республикасы Қорғаныс министрлігі Әскери-техникалық саясат департаменті қорғаныс тапсырысы, әскери-техникалық ынтымақтастық және сарапшылық бақылау басқармасы әскери-техникалық ынтымақтастықты және сарапшылық бақылауды іске асыру бөлімінің аға офицері

ИМАНАЛИЕВ Жәнібек Абдуләкімұлы – Қазақстан Республикасының Ұжымдық қауіпсіздік туралы шарт ұйымы жанындағы Тұрақты кеңестегі өкілетті өкілі

ИСАЕВА Гүлмира Сұлтанбайқызы – Қазақстан Республикасы Ауыл шаруашылығы вице-министрі

ҚАБДЕНОВА Ақмарал Талапқызы – Қазақстан Республикасы Денсаулық сақтау министрлігі Стратегиялық даму және заңнаманы үндестіру орталығы заңнаманы үндестіру басқармасының ЕАЭО мәселелері жөніндегі уәкілетті өкілі

ҚАБДОЛДАНОВ Тұрсын Айтмұхаметұлы – Қазақстан Республикасы Ауыл шаруашылығы министрлігі Ветеринариялық бақылау және қадағалау комитеті төрағасының орынбасары

ҚАЖЫМОВА Мәдина Маратқызы – Қазақстан Республикасы Ұлттық экономика министрлігі Сыртқы сауда қызметін дамыту департаменті тарифтік емес реттеу басқармасының бас сарапшысы

ҚАЗИЕВА Әсемгүл Амандыққызы – Қазақстан Республикасы Әділет министрлігі "Ұлттық зияткерлік меншік институты" республикалық мемлекеттік кәсіпорны тауар таңбалары, тауарлар және өнеркәсіптік үлгілер шығарылған жердің атаулары департаментінің бастығы

КӘКЕН Гүлнәр Қайратқызы – Қазақстан Республикасы Әділет министрлігі Зияткерлік меншік құқықтары департаменті директорының орынбасары

КАНАШКИНА Елена Анатольевна – Қазақстан Республикасы Ұлттық экономика министрлігі Салық және кеден саясаты департаменті кеден саясаты басқармасының басшысы

КӘРІМОВ Айдын Мейрамбекұлы – Қазақстан Республикасы Премьер-Министрі Кеңсесі сыртқы экономикалық ынтымақтастық және протокол бөлімінің меңгерушісі

КӘРІМОВА Эльвира Шағатайқызы – "Атамекен" Қазақстан Республикасы кәсіпкерлерінің ұлттық палатасы Кедендік әкімшілік жүргізу департаменті директорының орынбасары

КӘРІШЕВА Гүлнәр Құдайбергенқызы – Қазақстан Республикасы Қаржы министрлігі Қазынашылық комитеті түсімдерді есепке алу басқармасының бас қазынашысы – бас сарапшысы

ҚАСЕНОВ Файзрахман Айтқалиұлы – Қазақстан Республикасы Сыртқы істер министрлігі Еуразиялық интеграция департаменті директорының орынбасары

ҚАСЫМОВА Айгүл Қамитқызы – Қазақстан Республикасы Индустрия және инфрақұрылымдық даму министрлігінің Техникалық реттеу және метрология комитеті Техникалық реттеу және стандарттау басқармасының басшысы

КЕНИСПАЕВ Әлібек Айнабекұлы – Қазақстан Республикасы Ішкі істер министрлігі Әкімшілік полициясы комитеті төрағасының орынбасары

КОЖЕБАЕВ Ахметжан Алпысбайұлы – Қазақстан Республикасы Ұлттық экономика министрлігінің бас сарапшысы

КОЗЛОВ Юрий Степанович – Қазақстан Республикасы Ішкі істер министрлігі Әкімшілік полициясы комитеті Мемлекеттік автомобиль инспекциясы басқармасы бастығының орынбасары

ҚОЙШЫБАЕВ Ғалымжан Тельманұлы – Қазақстан Республикасы Премьер-Министрі Кеңсесінің басшысы

ҚОНЫСБАЕВ Ермұхамбет Болатбекұлы – Қазақстан Республикасы Сыртқы істер министрлігі Еуразиялық интеграция департаментінің директоры

КӨПБАСАРОВ Бақытбай Сайлаубайұлы – Қазақстан Республикасы Қаржы министрлігі Бухгалтерлік есеп, аудит және бағалау әдіснамасы департаменті ішкі мемлекеттік аудит әдіснамасы басқармасының басшысы

КӨШЕРБАЕВА Айнұр Мейірбекқызы – Қазақстан Республикасы Ұлттық банкі Банктік емес қаржы ұйымдарын реттеу департаментінің директоры

ҚУАНДЫҚОВА Мейіргүл Уәлиханқызы – Қазақстан Республикасы Цифрлық даму, қорғаныс және аэроғарыш өнеркәсібі министрлігі Ақпараттық-коммуникациялық технологиялар саласындағы мемлекеттік саясат департаменті жаңа технологиялар басқармасының басшысы

ҚҰБАШЕВ Әміржан Нұрланұлы - "Сауда саясатын дамыту орталығы" акционерлік қоғамының сарапшысы

ҚҰЛБОЛАТОВА Аида Оразалықызы – Қазақстан Республикасы Ұлттық банкі халықаралық ынтымақтастық департаменті интеграциялық ынтымақтастық басқармасының бастығы

ҚҰРМАНБАЕВ Бақыт Жанұзақұлы – Қазақстан Республикасы Қорғаныс министрінің орынбасары

ҚҰРМАНОВ Рүстем Жомартұлы – Қазақстан Республикасы Ауыл шаруашылығы вице-министрі

ҚҰСАЙЫНОВ Марат Әпсеметұлы – Еуразиялық экономикалық комиссияның Бәсекелестік және монополияға қарсы реттеу жөніндегі Алқа мүшесі (Министр) (2017 – 2019 жылдары)

КҮШІКОВА Жанель Сабырқызы – Қазақстан Республикасы Ұлттық экономика министрлігі Сыртқы сауда қызметін дамыту департаментінің директоры

ЛАСТАЕВ Талғат Тілеубекұлы – Қазақстан Республикасы Индустрия және инфрақұрылымдық даму министрлігі Азаматтық авиация комитетінің төрағасы

ЛЕПЕХА Игорь Владимирович – Қазақстан Республикасы Ішкі істер министрлігі Штаб-департаментінің бастығы

МАДАЛИЕВ Бақытжан Нұрханұлы – Қазақстан Республикасы Ұлттық экономика министрлігі Сыртқы сауда қызметін дамыту департаменті қорғау шараларын қолдану басқармасының бас сарапшысы

МАЙЛИНОВ Бақытжан Қырықбайұлы – Қазақстан Республикасы Қорғаныс министрлігі Метрологиялық қамтамасыз ету және стандарттау орталығының бастығы

МАҚАШЕВА Анар Жанарқызы – "Қазақстан автобизнесі қауымдастығы" заңды тұлғалар бірлестігінің вице-президенті

МАМИН Асқар Ұзақбайұлы – Қазақстан Республикасының Премьер-Министрі

МАНСҰРОВ Тайыр Аймұхаметұлы – Еуразиялық экономикалық комиссияның Энергетика және инфрақұрылым жөніндегі Алқа мүшесі (2014-2016 жылдары)

МАРС Алмабек Марсұлы – Қазақстан Республикасы Ауыл шаруашылығы министрлігі Агроөнеркәсіптік кешендегі мемлекеттік инспекция комитеті төрағасының орынбасары

МАХАМБЕТЖАН Айдана Қалыбайқызы – Қазақстан Республикасы Ұлттық экономика министрлігі Халықаралық экономикалық интеграция департаментінің Бірыңғай экономикалық кеңістікті қалыптастыру мәселелері басқармасының бас сарапшысы

МЕДЕУ Еділ Ахметқалұлы – Қазақстан Республикасы Ұлттық банкі Банктік емес қаржы ұйымдарын реттеу департаментінің бағалы қағаздар нарығын дамыту басқармасының бастығы

МЫРЗАҒАЛИЕВ Мағзұм Маратұлы – Қазақстан Республикасының Энергетика вице-министрі

МИЯТОВ Қайрат Исатайұлы – Қазақстан Республикасы Қаржы министрлігі Апелляция департаментінің директоры

МҰҚАТОВ Бексұлтан Кәріполлаұлы – Қазақстан Республикасы Әділет министрлігі Халықаралық экономикалық интеграция бойынша жобаларды сараптау департаменті өнеркәсіп, агроөнеркәсіптік кешен және техникалық реттеу саласындағы жобаларды сараптау басқармасының бас сарапшысы

МҰҚАТОВ Мейірбек Жақсыкелдіұлы – Қазақстан Республикасы Ақпарат және қоғамдық даму министрлігі Халықаралық ынтымақтастық департаменті директорының орынбасары

МҰҚЫШЕВ Алмаз Қайырбекұлы – Қазақстан Республикасы Ұлттық экономика министрлігі Салық және кеден саясаты департаменті кеден саясаты басқармасының бас сарапшысы

МҮТӘЛИЕВА Фарида Мәлікқызы – Қазақстан Республикасы Қаржы министрлігі Халықаралық қаржы қатынастары департаментінің директоры

НЕСОНОВ Евгений Григорьевич – "ҚазТрансГаз" акционерлік қоғамы маркетинг және келісімшарттар департаментінің директоры

НҮПІРОВ Жәнібек Мақсұтұлы – Қазақстан Республикасы Президенті Әкімшілігі әлеуметтік-экономикалық мониторинг бөлімі меңгерушісінің орынбасары

НҰРАШЕВ Тимур Бекболатұлы – Еуразиялық экономикалық комиссияның Техникалық реттеу және аккредиттеу департаментінің директоры

НҰРҒОЖИН Марат Рахмалыұлы – Қазақстан Республикасы Цифрлық даму, қорғаныс және аэроғарыш өнеркәсібі вице-министрі

ОЛЖАБАЕВ Қанат Жеңсікбайұлы – Қазақстан Республикасы Ұлттық экономика министрлігі Сыртқы сауда қызметін дамыту департаменті директорының орынбасары

ОРЫНТАЙ Нұрдәулет Қаныбекұлы – Қазақстан Республикасы Қаржы министрлігі Мемлекеттік кірістер комитетінің Цифрландыру және мемлекеттік қызметтер көрсету департаменті толассыз мониторинг басқармасының бас сарапшысы

ПІРІМБЕТОВ Тимур Владимирұлы – Қазақстан Республикасының Ресей Федерациясындағы Елшілігінің кеңесші уәкілі

РАЙХАНОВ Талғат Серікұлы – Қазақстан Республикасы Қаржы министрлігі Мемлекеттік кірістер комитетінің Кеден әдіснамасы департаменті энергия ресурстарына әкімшілік жүргізу басқармасының басшысы

РАҚЫМЖАН Данияр Нұғыманұлы – Қазақстан Республикасы Қаржы министрлігі Халықаралық қаржы қатынастары департаменті директорының орынбасары

РАХЫМОВ Қуат Жеңісұлы – Қазақстан Республикасы Қаржы министрлігі Мемлекеттік кірістер комитетінің Кеден әдіснамасы департаментінің директоры

САВЕЛЬЕВА Ксения Владимировна – Қазақстан Республикасы Ұлттық экономика министрлігі Салық және кеден саясаты департаменті кеден саясаты басқармасының бас сарапшысы

САҒЫНТАЕВ Бақытжан Әбдірұлы – Қазақстан Республикасы Президенті Әкімшілігінің басшысы

СӘЛІМБАЕВ Дәурен Ниязбекұлы – Қазақстан Республикасы Ұлттық банкінің қаржы нарығы әдіснамасы департаментінің директоры

СӘЛІМГЕРЕЙ Арон Аманжолұлы – Әл Фараби атындағы Қазақ ұлттық университеті Мемлекет және құқық институтының директоры

САПИНА Гаухар Талапқызы – Қазақстан Республикасы Ұлттық экономика министрлігінің Сыртқы сауда қызметін дамыту департаменті тарифтік емес реттеу басқармасының бас сарапшысы

САПИНА Жанна Талапқызы – Қазақстан Республикасы Әділет министрлігі Халықаралық экономикалық интеграция бойынша жобаларды сараптау департаментінің бас сарапшысы

СӘРСЕКЕЕВ Ерлан Медеуұлы – Қазақстан Республикасы Энергетика министрлігінің Халықаралық ынтымақтастық және экономикалық интеграциялық процестер департаменті экономикалық интеграциялық процестер басқармасының басшысы

СӘРСЕКЕЕВ Қуаныш Мейірбекұлы – Қазақстан Республикасы Энергетика министрлігі Газ және мұнай-газ-химия департаменті директорының орынбасары

САДУБАЕВА Әйгерім Нәбиқызы – Қазақстан Республикасы Денсаулық сақтау министрлігі Қоғамдық денсаулық сақтау комитетінің Техникалық регламенттерді бақылау басқармасының басшысы

СЕЙІЛОВ Ерлан Тоболұлы – Қазақстан Республикасы Ұлттық банкінің қаржы нарығы әдіснамасы департаментінің қаржы нарығын реттеу басқармасының бастығы

СЕЙДАЛИНА Әсел Жаңабайқызы – Қазақстан Республикасы Әділет министрлігі Халықаралық экономикалық интеграция бойынша жобаларды сараптау департаментінің бас сарапшысы

СЕЙФУЛЛИНА Айгүл Анатолийқызы – Қазақстан Республикасы Ұлттық экономика министрлігі Халықаралық экономикалық интеграция департаментінің бас сарапшысы

СИМОНЕНКО Анна Сергеевна – Қазақстан Республикасы Ауыл шаруашылығы министрлігінің Халықаралық ынтымақтастық департаменті ұйымдастыру іс-шаралары басқармасының басшысы

СКЛЯР Роман Васильевич – Қазақстан Республикасының Индустрия және инфрақұрылымдық даму министрі

СЛАМБЕКОВ Сәкен Талғатбекұлы – Қазақстан Республикасы Премьер-Министрі Кеңсесінің сыртқы экономикалық ынтымақтастық және протокол бөлімі интеграциялық бірлестіктермен өзара іс-қимыл секторының меңгерушісі

СМАҒҰЛОВА Ботагөз Балтайқызы – Қазақстан Республикасы Денсаулық сақтау министрлігінің Халықаралық ынтымақтастық және интеграция департаменті Еуразиялық интеграция мәселелері басқармасының басшысы

СМАЙЫЛОВ Әлихан Асханұлы – Қазақстан Республикасы Премьер-Министрінің Бірінші орынбасары - Қазақстан Республикасының Қаржы министрі

СЫРЫМБЕТОВ Айрат Сұңғатұлы – Қазақстан Республикасы Ұлттық экономика министрлігінің бас сарапшысы

СҮЛЕЙМЕНОВ Тимур Мұратұлы (Қазақстан Республикасы) – Қазақстан Республикасы Президентінің көмекшісі

СҰЛТАНОВ Руслан Серікұлы – фармацевтикалық және медициналық өнеркәсіп өндірушілерінің "ФармМедИндустрия Казахстана" қауымдастығының басшысы

СЫЗДЫҚОВА Айжан Ержанқызы – Қазақстан Республикасы Индустрия және инфрақұрылымдық даму министрлігі Индустриялық даму және өнеркәсіптік қауіпсіздік комитетінің бас сарапшысы

СЫЗДЫҚОВ Марат Зеникенұлы – Қазақстан Республикасы Сыртқы істер министрінің орынбасары

СЫЗДЫҚОВА Меруерт Сағидоллақызы – Қазақстан Республикасы Ұлттық экономика министрлігінің Сыртқы сауда қызметін дамыту департаменті сыртқы сауда келіссөздері басқармасының бас сарапшысы

СЫРҒАБАЕВ Ермек Тоққожаұлы – Қазақстан Республикасы Қаржы министрлігі Мемлекеттік кірістер комитетінің Цифрландыру және мемлекеттік қызметтер көрсету департаменті толассыз мониторинг басқармасы басшысының орынбасары

ТАЙЖАНОВ Жәнібек Жұмаұлы –Қазақстан Республикасы Индустрия және инфрақұрылымдық даму министрлігі Халықаралық экономикалық интеграция департаментінің директоры

ТЕҢГЕБАЕВ Ардақ Мырзабайұлы – Қазақстан Республикасы Республикалық бюджеттің атқарылуын бақылау жөніндегі есеп комитетінің мүшесі

ТІЛЕГЕНОВА Динара Серікқызы – Қазақстан Республикасы Ұлттық экономика министрлігінің Сыртқы сауда қызметін дамыту департаменті қорғау шараларын қолдану басқармасының басшысы

ТІЛЕУЛИН Рауан Манатұлы – Қазақстан Республикасы Премьер-Министрі Кеңсесі басшысының орынбасары

ТӨЛЕГЕНОВА Ардақ Орынбасарқызы – Қазақстан Республикасы Денсаулық сақтау министрлігі шаруашылық жүргізу құқығындағы "Дәрілік заттар мен медициналық бұйымдарды сараптау ұлттық орталығы" республикалық мемлекеттік кәсіпорнының Қазақстан Республикасы Мемлекеттік фармакопеясын және Еуразиялық экономикалық одақ Фармакопеясын әзірлеу және жетілдіру орталығының басшысы

ТҰРАРБЕКОВА Дидар Аманжолқызы– Қазақстан Республикасы Энергетика министрлігі Мұнай өнеркәсібін дамыту департаментінің бас сарапшысы

ТҰРҒЫМБАЕВ Ерлан Заманбекұлы – Қазақстан Республикасының Ішкі істер министрі

ТӨРЕБАЕВ Әділ Адамантұлы – Қазақстан Республикасы Ұлттық экономика министрлігінің бас сарапшысы

ТӨРЕХАНОВ Валихан Әмірханұлы – Қазақстан Республикасы Сыртқы істер министрлігі Тәуелсіз Мемлекеттер Достастығы департаментінің директоры

ТҰРСЫНОВ Әділ Қапанұлы – Қазақстан Республикасының Тұңғыш Президенті – Елбасының кеңесшісі - Қазақстан Республикасының Тұңғыш Президенті – Елбасы Кеңсесінің ақпараттық-талдамалық қамтамасыз ету бөлімінің меңгерушісі

ТҰЯҚОВ Дарын Шылбыұлы – Қазақстан Республикасы Цифрлық даму, қорғаныс және аэроғарыш өнеркәсібі вице-министрі

ОМАРОВА Гүлнәр Сартайқызы – Қазақстан Республикасы Қаржы министрлігі Қазынашылық комитеті түсімдерді есепке алу басқармасының басшысы

ОРАЗБЕКОВ Мақсат Сабыржанұлы – Қазақстан Республикасы Ұлттық экономика министрлігінің Салық және кеден саясаты департаменті кеден саясаты басқармасының бас сарапшысы

ӨТЕНОВ Аркен Хамитұлы – Қазақстан Республикасы Президенті Әкімшілігі Сыртқы саясат орталығы меңгерушісінің орынбасары

ҮШБАЕВА Бақытгүл Жұмақанқызы – Қазақстан Республикасы Ұлттық экономика министрлігі Макроэкономикалық талдау және болжау департаменті директорының орынбасары

ФАЗЫЛ Алмат Үйсінұлы – Еуразиялық экономикалық комиссияның Монополияға қарсы реттеу департаментінің директоры (2014-2016 жылдары)

ХАЖИДИНОВА Аселя Мамырбекқызы – Қазақстан Республикасы Әділет министрлігі Халықаралық экономикалық интеграция бойынша жобаларды сараптау департаменті өнеркәсіп, агроөнеркәсіптік кешен және техникалық реттеу саласындағы жобаларды сараптау басқармасының басшысы

ХАМЗИНА Альмира Қанатқызы – Қазақстан Республикасы Ұлттық экономика министрлігінің Сыртқы сауда қызметін дамыту департаменті сыртқы сауда келіссөздері басқармасының басшысы

ХАМИДУЛЛИНА Ботагоз Кеңесқызы – Қазақстан Республикасы Ұлттық экономика министрлігінің Салық және кеден саясаты департаменті директорының орынбасары

ХАСЕНОВ Марат Майданұлы – Қазақстан Республикасы Ішкі істер министрлігі Төтенше жағдайлар комитетінің Апаттар тәуекелін кеміту және азаматтық қорғау саласындағы бақылау басқармасының бастығы

ЦОЙ Алексей Владимирович – "Қазақстан Республикасы Президенті Іс Басқармасының Медициналық орталығы" мемлекеттік мекемесінің басшысы

ЦОЙ Елена Олеговна – "Сауда саясатын дамыту орталығы" акционерлік қоғамы өнеркәсіп және кәсіпкерлік секторының басшысы

ЧИГАМБАЕВ Даур Батырұлы – "Сауда саясатын дамыту орталығы" акционерлік қоғамы агроөнеркәсіптік кешен секторының басшысы

ШАЙМАҒАМБЕТОВ Еркін Мұстафаұлы – Қазақстан Республикасы Цифрлық даму, қорғаныс және аэроғарыш өнеркәсібі министрлігі Аэроғарыш комитетінің төрағасы (2016-2019 жылдары)

ШАҚАРОВ Қайрат Қалиасқарұлы – Қазақстан Республикасы Ұлттық экономика министрлігінің бас сарапшысы

ШАҚҚАЛИЕВ Арман Абайұлы – Қазақстан Республикасы Индустрия және инфрақұрылымдық даму министрлігі Техникалық реттеу және метрология комитетінің төрағасы

ШАЛБАЕВ Айдар Есламбекұлы – Қазақстан Республикасы Сыртқы істер министрлігі Еуразиялық интеграция департаментінің басқарма басшысы

ШАЛҒЫМБАЕВ Заман Дәулетжанұлы – Қазақстан Республикасы Ұлттық экономика министрлігі Ақпаратты қорғау департаментінің директоры

ЮДИН Николай Васильевич – "Теңіз көлігі кәсіпкерлері қауымдастығы" коммерциялық емес заңды тұлғалар бірлестігінің директоры

Қырғыз Республикасынан

АБДРАЛИЕВА Гулмира Курманбековна – Қырғыз Республикасы Үкіметі Аппараты құрылыс, көлік және коммуникациялар бөлімінің меңгерушісі

АБДЫГУЛОВ Толкунбек Сагынбекович – Қырғыз Республикасы Ұлттық банкі төрағасы

АБДЫКАИМОВ Октябрь Абдыкаимович – Қырғыз Республикасы Үкіметі жанындағы Мемлекеттік салық қызметінің төрағасы (2017-2018 жылдары)

АБДЫРАИМОВА Роза Аскарбековна – Қырғыз Республикасы Экономика министрлігінің Халықаралық ынтымақтастық және интеграциялық процестер басқармасы ЕАЭО-мен жұмыс бөлімінің бас маманы

АЗИМОВ Алмазбек Курбаналиевич – Қырғыз Республикасы Қаржы министрінің орынбасары

АЙДАРБЕКОВ Айбек Акматбекович – Қырғыз Республикасы Үкіметі Аппараты халықаралық ынтымақтастық бөлімінің меңгерушісі

АКЫНБЕКОВ Алмаз Эмильбекович – Қырғыз Республикасы Үкіметі жанындағы Мемлекеттік кеден қызметінің Кеден төлемдері басқармасы тарифтік реттеу бөлімінің бас инспекторы

АЛИМБЕКОВ Морисбек Шаршеналиевич – Қырғыз Республикасы Ауыл шаруашылығы, тамақ өнеркәсібі және мелиорация министрлігі Химияландыру департаментінің өсімдіктер карантині бөлімінің меңгерушісі (2014-2016 жылдары)

АЛИШЕРОВ Эльдар Туралиевич – Қырғыз Республикасы Экономика министрінің орынбасары

АЛЫБАЕВ Канай Мыктыбекович – Қырғыз Республикасы Үкіметі жанындағы Мемлекеттік кеден қызметінің Кедендік ынтымақтастық басқармасы ЕАЭО мәселелері бөлімінің бастығы

АСАНБАЕВ Алмазбек Жолчуевич – Қырғыз Республикасы Үкіметі жанындағы Мемлекеттік көші-қон қызметі төрағасының орынбасары (2016-2018 жылдары)

АСАНОВ Сапарбек Жекшебаевич – Қырғыз Республикасы "Легпром"

жеңіл өнеркәсіп кәсіпорындары қауымдастығының президенті

АСАНОВ Уланбек Жалалович – Қырғыз Республикасы Әлеуметтік қоры төрағасының орынбасары

АСЫЛБЕКОВ Жумабек Асылбекович – Қырғыз Республикасы Ауыл шаруашылығы, тамақ өнеркәсібі және мелиорация министрлігі азық-түлік қауіпсіздігі және агромаркетинг басқармасының бастығы (2011-2016 жылдары)

АХМАТОВ Султан Маматович – Қырғыз Республикасы Экономика министрлігінің Көмек стратегиясы басқармасының бастығы

АХМАТОВА Индира Булатбековна – Қырғыз Республикасы Экономика министрлігінің Халықаралық ынтымақтастық және интеграциялық процестер басқармасының бастығы

АХМЕТОВА Нурсулу Меирбековна – Қырғыз Республикасы Президенті Аппараты стратегиялық талдау саясаты, экономика және қаржы бөлімінің меңгерушісі (2012-2015 жылдары, 2017-2018 жылдары)

БАЙЗАКОВ Самат Шейшенбекович – Қырғыз Республикасы Үкіметі жанындағы Зияткерлік меншік және инновациялар мемлекеттік қызметі бастығының орынбасары

БЕГАЛИЕВ Аскат Маратович – Қырғыз Республикасы Қаржы министрлігінің Мемлекеттік кірістерді болжау басқармасы ЕАЭО шеңберіндегі өзара іс-қимылды үйлестіру секторының меңгерушісі

ГОРЯНОВА Оксана Васильевна – Қырғыз Республикасы Үкіметі жанындағы Монополияға қарсы реттеу мемлекеттік агенттігі бәсекелестік ортаны талдау және ЕЭК-пен өзара іс-қимыл бөлімінің бас маманы

ДЖАКЫПОВ Кылычбек Джумадилович – Қырғыз Республикасы Экономика министрінің орынбасары (2014 - 2016 жылдары)

ДЖУМАБЕКОВ Нурлан Кадыржанович – Қырғыз Республикасы Үкіметі жанындағы Мемлекеттік салық қызметінің Жанама салықтарды бақылау басқармасы жанама салықтар бөлімінің бастығы

ДЖУСУПОВА Джаныл Джусуповна – Еуразиялық экономикалық комиссияның Техникалық реттеу және аккредиттеу департаменті директорының орынбасары

ДИЛЬ Валерий Исидорович – Қырғыз Республикасының вице-премьер-министрі (2014 – 2015 жылдары)

ДУЙШЕМБИЕВА Бактыгуль Мукамбетовна – Қырғыз Республикасы Экономика министрлігінің Халықаралық ынтымақтастық және интеграциялық процестер басқармасы ЕАЭО-мен жұмыс бөлімінің бас маманы

ДУСУМБАЕВ Нурлан Джапсарбаевич – "Кыргыз темир жолу" Ұлттық компаниясы" мемлекеттік кәсіпорны экономика, стратегиялық даму және тарифтік саясат басқармасының бастығы

ЖУМАБАЕВ Максат Искендербекович – "Қырғызстан ұлттық электр желісі" ашық акционерлік қоғамы шарттар, сату және есептеу бөлімінің бастығы

ЖУМАКАНОВ Калысбек Туратбекович – Қырғыз Республикасы Үкіметі жанындағы Ветеринариялық және фитосанитариялық қауіпсіздік мемлекеттік инспекциясының директоры

ИБРАЕВ Данил Турсунбекович – Қырғыз Республикасы Экономика министрінің орынбасары (2013 - 2016 жылдары)

ИМАНАЛИЕВ Данияр Шаршенбекович – Қырғыз Республикасы Президенті Аппараты стратегиялық даму саясаты, экономика және қаржы бөлімінің меңгерушісі

ИСАБАЕВА Зина Беккелдиевна – Еуразиялық экономикалық комиссияның Кәсіпкерлік қызметті дамыту департаменті директорының орынбасары

ИСАЕВ Амангелди Сапарбекович – Қырғыз Республикасы Ауыл шаруашылығы, тамақ өнеркәсібі және мелиорация министрлігі Өсімдіктер карантині департаментінің директоры

ИСМАИЛОВА Гульсара Акимовна – Қырғыз Республикасы Мемлекеттік шекара қызметі Шекаралық бақылау басқармасы бастығының орынбасары

КАДЫРКУЛОВ Мукай Асанович – Еуразиялық экономикалық комиссияның Кедендік ынтымақтастық жөніндегі Алқа мүшесі (Министр)

КАЗЫМБЕКОВА Светлана Рыскулбековна – Қырғыз Республикасы Өнеркәсіп, энергетика және жер қойнауын пайдалану мемлекеттік комитетінің Машина жасау, металлургия және құрылыс материалдары басқармасы ЕАЭО-мен жұмыс секторының меңгерушісі

КАЙКИЕВ Эмиль Абдыкалыевич – Еуразиялық экономикалық комиссияның Энергетика және инфрақұрылым жөніндегі Алқа мүшесі (Министр)

КАСЫМАЛИ уулу Каныбек – Қырғыз Республикасы Президенті Аппараты стратегиялық талдау саясаты, экономика және қаржы бөлімінің сарапшысы

КИСЕЛЕВА Римма Хаджимуратовна – Еуразиялық экономикалық комиссияның Интеграцияны дамыту департаменті директорының орынбасары

КОЖОШЕВ Арзыбек Орозбекович – Қырғыз Республикасының Экономика министрі (2015 – 2017 жылдары)

КОЧКОРОВ Алмазбек Тойчубаевич – Қырғыз Республикасы Қаржы министрлігі Мемлекеттік кірістерді болжау басқармасының бастығы

КУДАБАЕВ Кубанычбек Карыпбекович – Қырғыз Республикасы Үкіметі Аппараты сыртқы көмекті үйлестіру секторының меңгерушісі

КУЛМАМБЕТОВ Самат Дилдемуратович – Қырғыз Республикасы Үкіметі Аппаратының - Қырғыз Республикасы Үкіметінің ЕАЭО істері жөніндегі Арнаулы өкілі хатшылығының бөлімі меңгерушісінің орынбасары

КУЛМУРЗАЕВ Азамат Шамсудинович – Қырғыз Республикасы Ұлттық банкі халықаралық ынтымақтастық бөлімінің жетекші экономисі

МАМЕТОВ Рустам Асхатович – Қырғыз Республикасының Ресей Федерациясындағы Елшілігінің екінші хатшысы

МАМЫРКАЛИЕВ Эрмек Алтымышевич – Қырғыз Республикасы Көлік және жолдар министрлігі статс-хатшысының міндетін атқарушы

МАТЕЕВ Азиз Уларбекович – Қырғыз Республикасы Үкіметі жанындағы Ветеринариялық және фитосанитариялық қауіпсіздік мемлекеттік инспекциясының халықаралық ынтымақтастық және ЕАЭО-мен жұмыс бөлімінің бас маманы

МУКАЕВ Нурсултан Айдарбекович – Қырғыз Республикасы Көлік және жолдар министрлігі сыртқы байланыстар және интеграция бөлімінің бас маманы

МУКАНБЕТОВ Санжар Турдукожоевич – Қырғыз Республикасы Үкіметі жанындағы Қаржы нарықтарын реттеу және қадағалау мемлекеттік қызметінің төрағасы

МУЛКУБАТОВ Календер Нурланович – Қырғыз Республикасы Үкіметі Аппараты сыртқы саясат бөлімінің сарапшысы

МУСАБЕКОВ Нурмат Болотбекович – Қырғыз Республикасы Көлік және жолдар министрлігі Автомобиль және теміржол көлігі басқармасының бас маманы

НУРДИНОВА Айзаада Касымбековна – Қырғыз Республикасы Үкіметінің ЕАЭО істері жөніндегі Арнаулы өкілі хатшылығының сарапшысы

ОМОКЕЕВ Айбек Талгатбекович – Қырғыз Республикасы Сыртқы істер министрлігінің статс-хатшысы

ОРМУШЕВА Мээрим Айдарбековна – Қырғыз Республикасы Үкіметі жанындағы Зияткерлік меншік және инновациялар мемлекеттік қызметінің Құқық басқармасы құқықтық қамтамасыз ету бөлімінің меңгерушісі

ОРОЗБЕКОВ Алымбек Асылбекович – Қырғыз Республикасы Өнеркәсіп, энергетика және жер қойнауын пайдалану мемлекеттік комитеті төрағасының орынбасары (2017-2018 жылдары)

ОТОРБАЕВ Джоомарт Каипович – Қырғыз Республикасының Премьер-министрі (2014-2015 жылдары)

ПАНКРАТОВ Олег Михайлович – Қырғыз Республикасының Экономика министрі (2018-2019 жылдары)

ПОНОМАРЕВ Сергей Васильевич – Қырғыз Республикасы базарлар қауымдастығының президенті

РАЗАКОВ Жениш Парпиевич – Қырғыз Республикасының вице-премьер-министрі

РАХИМОВ Кубатбек Калыевич – Қырғыз Республикасы Премьер-министрінің кеңесшісі

САДАМКУЛОВА Фатима Исагуловна – Қырғыз Республикасы Өнеркәсіп, энергетика және жер қойнауын пайдалану мемлекеттік комитеті жеңіл өнеркәсіп және өзге де салалар бөлімінің меңгерушісі

САЗБАКОВ Алмаз Замирбекович – Қырғыз Республикасы Үкіметінің ЕАЭО істері жөніндегі Арнаулы өкілі

САРИЕВ Темир Аргембаевич – Қырғыз Республикасының Премьер-министрі (2015-2016 жылдары)

САТЫБЕКОВА Гулсара Назарбековна – Ұлттық статистика комитетінің сауда статистикасы басқармасы сыртқы сауда статистикасы бөлімінің меңгерушісі

САЯКБАЕВ Данияр Асылбекович – Қырғыз Республикасы Сыртқы істер министрлігі Халықаралық-құқық департаменті директорының орынбасары

СУБАКОЖОЕВА Айзада Муратбековна – Қырғыз Республикасы Президенті Аппараты ішкі саясат бөлімі ахуалдық-талдау секторының меңгерушісі (2016-2017 жылдары); Қырғыз Республикасы Президенті Аппараты ішкі саясат бөлімінің меңгерушісі (2017-2018 жылдары)

ТАЙЛАКОВ Кенешбай Доскулович – Қырғыз Республикасы Үкіметі жанындағы Монополияға қарсы реттеу мемлекеттік агенттігі директорының орынбасары

ТОКТОНАЛИЕВА Бюбюсара Жапаркуловна – Қырғыз Республикасы Экономика министрлігі Сауда саясаты басқармасының сауда саясаты және экспортты дамыту бөлімінің меңгерушісі

ТОРУТАЕВ Алтынбек Элимович – Қырғыз Республикасы Үкіметі жанындағы Мемлекеттік кеден қызметі төрағасының орынбасары

ТУРСУНКУЛ уулу Сатар – Қырғыз Республикасы Президенті Аппараты қаржы-экономикалық талдау және даму мониторингі бөлімінің сарапшысы (2013-2014 жылдары)

УМЕТАЛИЕВ Санжар Болотбекович – Қырғыз Республикасы Үкіметі Аппараты басшысының орынбасары (2016-2018 жылдары)

УСКЕНБАЕВА Гульнара Тураровна – "Өнім берушілер (өндірушілер мен дистрибьюторлар) қауымдастығы" заңды тұлғалар бірлестігінің президенті

УСУПОВ Усен Макаевич – Еуразиялық экономикалық комиссияның Энергетика және инфрақұрылым жөніндегі Алқа мүшесі (Министр) Хатшылығының басшысы

ЧЕРНЫЙ Илья Анатольевич – Еуразиялық экономикалық комиссияның Ішкі нарықтардың жұмыс істеуі департаментінің директоры

ЧОДУЕВ Эркинбек Урайымович – Қырғыз Республикасы Ауыл шаруашылығы, тамақ өнеркәсібі және мелиорация министрінің орынбасары

ШАМШИЕВ Улан Насирдинович – Қырғыз Республикасы Үкіметі жанындағы Көші-қон мемлекеттік қызметі сыртқы көші-қон бөлімінің меңгерушісі

ШАРШЕКЕЕВ Марат Дуйшебаевич – Қырғыз Республикасы Сауда-өнеркәсіп палатасының президенті

ШАТЕМИРОВ Кубанычбек Таалайбекович – Қырғыз Республикасы Ақпараттық технологиялар және байланыс мемлекеттік комитеті төрағасының орынбасары

ЫРСАЛИЕВ Толонбек Кошоевич – Қырғыз Республикасы Үкіметі жанындағы Ветеринариялық және фитосанитариялық қауіпсіздік мемлекеттік инспекциясы шекаралық және ветеринариялық бақылау бөлімінің меңгерушісі

ЫСАБЕКОВ Кубанычбек Абдимуталипович – Қырғыз Республикасы Экономика министрлігі Салық саясаты басқармасы салық саясаты бөлімінің меңгерушісі

Ресей Федерациясынан

АБРАМЯН Рафаэл Михайлович – Ресей Федерациясы Экономикалық даму министрлігі ТМД елдерімен экономикалық ынтымақтастық және Еуразиялық интеграцияны дамыту департаментінің директоры

АГАФОНОВ Денис Владимирович – Ресей Федерациясы Президенті Сыртқы саясат басқармасы бастығының орынбасары

АЛАФИНОВ Иннокентий Сергеевич – Ресей Федерациясы Көлік министрінің бірінші орынбасары

АЛЕКСАНДРОВ Роман Владимирович – Ресей Федерациясы Көлік министрлігінің Халықаралық ынтымақтастық департаментінің директоры

АНДРИЯШИНА Наталья Вадимовна – Федералдық тұтынушылар құқықтарын және адамның саламаттылығын қорғау саласындағы қадағалау қызметі Құқықтық басқармасының бастығы

АНТИПОВ Михаил Константинович – "Ресей экспорттық кредиттер мен инвестицияларды сақтандандыру агенттігі" акционерлік қоғамының сыртқы экономикалық қызмет саласын реттеу мәселелері жөніндегі директоры

АНТОНОВ Владимир Станиславович – Федералдық денсаулық сақтау саласындағы қадағалау қызметінің "Мониторинг және клиникалық-экономикалық сараптама орталығы" федералдық мемлекеттік бюджеттік мекемесі бас директорының көмекшісі

АРТЕМЬЕВ Игорь Юрьевич – Федералдық монополияға қарсы қызмет басшысы

АСТАПЕНКО Елена Михайловна – Федералдық денсаулық сақтау саласындағы қадағалау қызметі Медициналық бұйымдарды мемлекеттік бақылауды және тіркеуді ұйымдастыру басқармасының бастығы

АФАНАСЬЕВ Сергей Григорьевич – Ресей Федерациясы Ауыл шаруашылығы министрлігі Тамақ және өңдеуші өнеркәсіп департаменті техникалық реттеу бөлімінің бастығы

БАРАНОВА Марья Андреевна – Ресей Федерациясы Экономикалық даму министрлігі Сауда келіссөздері департаменті директорының орынбасары

БЕЛОУСОВ Андрей Рэмович – Ресей Федерациясы Президентінің көмекшісі

БЕЛЬСКАЯ Елена Владимировна – Ресей Федерациясы Экономикалық даму министрлігі Реттеуші әсерді бағалау департаменті директорының орынбасары

БОГОМОЛОВА Полина Олеговна – Ресей Федерациясы Үкіметі Баспасөз қызметі және ақпарат департаментінің 1 разрядты жетекші маманы

БОКАРЕВ Андрей Андреевич – Ресей Федерациясы Қаржы министрлігі Халықаралық қаржы қатынастары департаментінің директоры

БОЛДЫРЕВА Виктория Викторовна – Ресей Федерациясы Үкіметі Протокол департаментінің маман-сарапшысы

БРАГИНА Ирина Викторовна – Федералдық тұтынушылар құқықтарын және адамның саламаттылығын қорғау саласындағы қадағалау қызметі басшының орынбасары

БРАТЧИКОВ Александр Сергеевич – Ресей Федерациясы Президенті Сыртқы саясат басқармасының бас кеңесшісі

БУЛАВИН Владимир Иванович – Федералдық кеден қызметінің басшысы

БУРЛАК Андрей Александрович – Федералдық аккредиттеу қызметі Құқықтық қамтамасыз ету және халықаралық ынтымақтастық басқармасының бастығы

ВЛАСОВ Николай Анатольевич – Федералдық ветеринариялық және фитосанитариялық қадағалау қызметі басшысының орынбасары

ВОЛКОВ Алексей Михайлович – Ресей Федерациясы Қаржы министрлігі Салық және кеден саясаты департаменті кедендік әкімшілік жүргізу бөлімінің бастығы

ГАЛЬПЕРИН Михаил Львович – Ресей Федерациясының Еуропалық Сот жанындағы Адам құқығы жөніндегі уәкілі - Ресей Федерациясы Әділет министрінің орынбасары

ГЕРАСИМОВ Евгений Игоревич – Ресей Федерациясы Экономикалық даму министрлігі ТМД елдерімен экономикалық ынтымақтастық және Еуразиялық интеграцияны дамыту департаментінің Еуразиялық экономикалық одақтың ұлтүсті институттарын дамыту бөлімі бастығының орынбасары

ГЕРАЩЕНКО Илья Владимирович – Ресей Федерациясы Ауыл шаруашылығы министрлігі Халықаралық ынтымақтастық департаменті директорының орынбасары

ГЛАГОЛЕВ Сергей Владимирович – Федералдық денсаулық сақтау саласындағы қадағалау қызметі Медициналық өнімнің сапасын мемлекеттік бақылауды ұйымдастыру басқармасы бастығының орынбасары - фармакологиялық қадағалауды ұйымдастыру бөлімінің бастығы

ГЛАДКОВ Александр Алексеевич – Ресей Федерациясы Энергетика министрлігі Мұнай мен газды өндіру және тасымалдау департаментінің директоры

ГОГОТИШВИЛИ Давид Мерабович – Ресей Федерациясы Өнеркәсіп және сауда министрлігі Техникалық реттеу, стандарттау және өлшем бірліктерін қамтамасыз ету саласындағы мемлекеттік саясат департаменті директорының орынбасары

ГОЛЕНДЕЕВА Татьяна Николаевна – Федералдық кеден қызметі басшысының орынбасары

ГОЛИКОВ Максим Юрьевич – Ресей Федерациясы Президенті Сараптау басқармасының департамент бастығы

ГОЛОМОЛЗИН Анатолий Николаевич – Федералдық монополияға қарсы қызмет басшысының орынбасары

ГОРЬКОВ Сергей Николаевич – "Росгеология" акционерлік қоғамы басқарма төрағасы – бас директоры

ГРАЧЕВА Мария Алексеевна – Федералдық кеден қызметі Талдау басқармасы бастығының орынбасары

ГРУЗДЕВ Алексей Владимирович – Ресей Федерациясы Өнеркәсіп және сауда министрінің орынбасары

ГУДИН Виталий Васильевич – Ресей Федерациясы Экономикалық даму министрлігі Сыртқы экономикалық қызметті дамыту және реттеу департаментінің директоры (2017-2019 жылдары), Ресей Федерациясының 3- сыныпты толық шенді мемлекеттік кеңесшісі

ГУТОРОВ Тимофей Евгеньевич – Федералдық ветеринариялық және фитосанитариялық қадағалау қызметі Экспорттық-импорттық операциялар кезіндегі, көліктегі ветеринариялық қадағалау және халықаралық ынтымақтастық басқармасының сыртқы ветеринариялық қадағалау және халықаралық ынтымақтастық бөлімінің бастығы

ДАВЫДОВ Руслан Валентинович – Федералдық кеден қызметі басшысының бірінші орынбасары

ДАВЫДОВА Леся Евгеньевна – Федералдық монополияға қарсы қызмет Халықаралық экономикалық ынтымақтастық басқармасының бастығы

ДАНИЛЬЧЕВА Кира Сергеевна – Ресей Федерациясы Экономикалық даму министрлігі Сыртқы экономикалық қызметті дамыту және реттеу департаментінің тарифтік жеңілдіктер мен преференциялар бөлімінің жетекші кеңесшісі

ДАНКВЕРТ Сергей Алексеевич – Федералдық ветеринариялық және фитосанитариялық қадағалау қызметінің басшысы

ДАУШЕВ Артем Адгамович – Федералдық ветеринариялық және фитосанитариялық қадағалау қызметі басшысының кеңесшісі

ДЕЙНЕКО Ирина Анатольевна – Ресей Федерациясы Өнеркәсіп және сауда министрлігінің Еуропа, Солтүстік Америка, ТМД елдері және көптарапты экономикалық ынтымақтастық департаменті Еуразиялық интеграция бөлімінің бастығы

ДЕЛИЗОНАС Татьяна Сергеевна – Ресей Федерациясы Орталық банкі Халықаралық ынтымақтастық департаменті халықаралық ынтымақтастықты үйлестіру басқармасының бастығы

ДЕРБЕНЕВ Евгений Анатольевич – Ресей Федерациясы Үкіметі Төрағасының Бірінші орынбасары - Ресей Федерациясы Қаржы министрі А.Г.Силуановтың Хатшылығының басшысы

ДЖАФАРОВА Сабина Фархадовна – Ресей Федерациясы Экономикалық даму министрлігі ТМД елдерімен экономикалық ынтымақтастық және Еуразиялық интеграцияны дамыту департаментінің Еуразиялық экономикалық одақтың үшінші елдермен халықаралық ынтымақтастығы бөлімінің жетекші консультанты

ДИТРИХ Евгений Иванович – Ресей Федерациясының Көлік министрі

ДМИТРИЕВ Максим Викторович – Ресей Федерациясы Үкіметі Халықаралық ынтымақтастық департаменті директорының орынбасары

ДЬЯЧЕНКО Алексей Владимирович – Ресей Федерациясы Сыртқы істер министрлігі ТМД елдері Бірінші департаментінің бірінші хатшысы

ЕВДОКИМОВ Михаил Николаевич – Ресей Федерациясы Сыртқы істер министрлігі ТМД елдері Бірінші департаментінің директоры

ЕВТУХОВ Виктор Леонидович – Ресей Федерациясы Өнеркәсіп және сауда министрінің орынбасары – статс-хатшы

ЕЖОВ Сергей Павлович – Ресей Федерациясы Сыртқы істер министрлігі ТМД елдері Бірінші департаменті директорының орынбасары

ЕПИФАНОВА Надежда Васильевна – Ресей Федерациясы Көлік министрлігі Халықаралық ынтымақтастық департаменті үкіметаралық комиссиялар және ТМД елдері бөлімінің консультанты

ЖУКОВ Дмитрий Борисович – Федералдық кеден қызметі Кедендік ресімдеу және кедендік бақылау бас басқармасының бастығы

ЗАВЬЯЛОВ Дмитрий Олегович – Ресей Федерациясы Үкіметі Төрағасының Бірінші орынбасары - Ресей Федерациясы Қаржы министрі А.Г.Силуановтың көмекшісі

ЗАМОРИНА Татьяна Юрьевна – Федералдық кеден қызметі талдау басқармасы сыртқы сауда статистикасы және әдіснамасы бөлімі бастығының орынбасары

ЗВЕРЕВ Дмитрий Станиславович – Ресей Федерациясы Көлік министрінің орынбасары – статс-хатшы

ЗМЕЕВСКАЯ Татьяна Евгеньевна – Федералдық зияткерлік меншік қызметі Мемлекеттік қызметтер көрсету ұсынуды ұйымдастыру басқармасының құралдарды дараландыру бөлімінің бастығы

ЗОЛКИН Никита Андреевич – Ресей Федерациясы Қаржы министрлігінің Салық және кеден саясаты департаменті директорының орынбасары

ИВАЩЕНКО Александра Вячеславовна – Ресей Федерациясы Үкіметі Баспасөз қызметі және ақпарат департаментінің бас кеңесшісі

ИВЛИЕВ Григорий Петрович – Федералдық зияткерлік меншік қызметінің басшысы

КАЛИНИНА Анастасия Александровна – Ресей Федерациясы Үкіметі Протокол департаменті бөлімінің кеңесшісі

КАМИНСКАЯ Ксения Артемовна – Ресей Федерациясы Үкіметі Баспасөз қызметі және ақпарат департаменті директорының орынбасары

КАРАСИН Григорий Борисович – Ресей Федерациясы Сыртқы істер министрінің орынбасары – статс-хатшы

КАШЕВАРОВ Андрей Борисович – Федералдық монополияға қарсы қызмет басшысының орынбасары

КВАСОВ Алексей Григорьевич – Ресей Федерациясы Президенті Сараптау басқармасы бастығының орынбасары

КИМ Ольга Эдуардовна – Ресей Федерациясы Үкіметі Халықаралық ынтымақтастық департаменті бөлімінің бас консультанты

КИРИЙ Любовь Леонидовна – Федералдық зияткерлік меншік қызметі басшысының орынбасары

КИСЕЛЕВА Елена Николаевна – Ресей Федерациясы Экономикалық даму министрлігі ТМД елдерімен экономикалық ынтымақтастық және Еуразиялық интеграцияны дамыту департаменті директорының орынбасары - Еуразиялық экономикалық одақтың үшінші елдермен халықаралық ынтымақтастығы бөлімінің бастығы

КЛИМОВА Наталия Юрьевна – Ресей Федерациясы Үкіметі Құқықтық департаменті бөлімінің бас кеңесшісі

КОЗЛОВ Дмитрий Николаевич – Ресей Федерациясы Экономикалық даму министрлігі Сыртқы экономикалық қызметті дамыту және реттеу департаментінің СЭҚ нормативтік қамтамасыз ету бөлімінің бастығы

КОМАРОВА Светлана Владимировна – Ресей Федерациясы Еңбек және әлеуметтік қорғау министрлігі Зейнетақымен қамтамасыз ету департаменті директорының орынбасары

КОНСТАНТИНОВ Андрей Евгеньевич – Федералдық кеден қызметі Талдау басқармасы бастығының бірінші орынбасары – кедендік статистика бөлімінің бастығы

КОРОБЧЕНКО Сергей Викторович – Федералдық ветеринариялық және фитосанитариялық қадағалау қызметі Экспорттық-импорттық операциялар кезіндегі, көліктегі ветеринариялық қадағалау және халықаралық ынтымақтастық басқармасының сыртқы сауда операциялары кезіндегі және көліктегі ветеринариялық бақылау бөлімінің бастығы

КОРОТКОВА Наталья Анатольевна – Ресей Федерациясы Үкіметі Баспасөз қызметі және ақпарат департаментінің референті

КОСМАЧҢВ Дмитрий Викторович – Ресей Федерациясы Орталық банкі қаржы ұйымдары қызметіне рұқсат беру және тоқтату департаменті қаржы ұйымдары қызметіне рұқсат беру және тоқтату әдіснамасы басқармасының жоба жетекшісі

КОСТЕННИКОВ Дмитрий Вячеславович – Ресей Федерациясы Денсаулық сақтау министрінің орынбасары – статс-хатшы

КОСТЮК Андрей Александрович – Федералдық жол агенттігінің басшысы

КОТОВ Владимир Александрович – Ресей Федерациясы Үкіметі Протокол департаменті бөлімі бастығының орынбасары

КРАСОЧЕНКОВА Наталья Петровна – Ресей Федерациясы Үкіметі Экономика және қаржы департаменті директорының орынбасары

КРЮЧКОВА Наталья Владимировна – Ресей Федерациясы Орталық банкі Халықаралық ынтымақтастық департаменті халықаралық ынтымақтастықты үйлестіру басқармасы интеграциялық ынтымақтастық бөлімі бастығының орынбасары

КУВЫРКОВ Глеб Борисович – Федералдық зияткерлік меншік қызметі Халықаралық ынтымақтастық басқармасы өңірлік интеграция бөлімінің бастығы

КУЗЕНКО Петр Иванович – Ресей Федерациясы Денсаулық сақтау министрлігі Қаржы-экономика департаменті директорының орынбасары

КУЛЕШОВ Андрей Васильевич – Ресей Федерациясы Экономикалық даму министрлігі Сауда келіссөздері департаментінің тауарлар саудасы бөлімінің бастығы

ЛАВРОВ Сергей Викторович – Ресей Федерациясының Сыртқы істер министрі

ЛЕВИН Сергей Львович – Ресей Федерациясы Ауыл шаруашылығы министрінің орынбасары

ЛЕОНОВ Петр Валерьевич – Ресей Федерациясы Үкіметі Экономика және қаржы департаментінің бөлім бастығы

ЛЕСНИКОВА Марина Николаевна – Ресей Федерациясы Денсаулық сақтау министрлігі Құқықтық департаменті директорының орынбасары

ЛИХАЧЕВ Алексей Евгеньевич – Атом энергиясы жөніндегі "Росатом" мемлекеттік корпорациясының бас директоры

ЛОБАНОВ Максим Андреевич – Ресей Федерациясы Үкіметі Өнеркәсіп және инфрақұрылым департаментінің референті

ЛОЗОВАЯ Анна Николаевна – Ресей Федерациясы Қаржы министрлігінің Салық және кеден саясаты департаменті қосылған құн салығы бөлімінің бастығы

ЛОКТИОНОВА Елена Александровна – Ресей Федерациясы Экономикалық даму министрлігі ТМД елдерімен экономикалық ынтымақтастық және Еуразиялық интеграцияны дамыту департаментінің Еуразиялық экономикалық одақта ұлтүсті институттарын дамыту бөлімінің бастығы

ЛУТ Оксана Николаевна – Ресей Федерациясы Ауыл шаруашылығы министрінің орынбасары

МАЙОРОВА Екатерина Евгеньевна – Ресей Федерациясы Экономикалық даму министрлігі Сауда келіссөздері департаментінің директоры

МАКСИМКИНА Елена Анатольевна – Ресей Федерациясы Денсаулық сақтау министрлігі Дәрімен қамтамасыз ету және медициналық бұйымдар айналысын реттеу департаментінің директоры

МАКСИМОВ Андрей Геннадьевич – Ресей Федерациясы Энергетика министрлігі Электр энергетикасын дамыту департаменті директорының орынбасары

МАКСИМОВ Тимур Игоревич – Ресей Федерациясы Экономикалық даму министрінің орынбасары

МАМОНОВ Михаил Викторович – Ресей Федерациясы Цифрлық даму, байланыс және бұқаралық коммуникациялар министрінің орынбасары

МАНТУРОВ Денис Валентинович – Ресей Федерациясы Өнеркәсіп және сауда министрі

МАРКОВИЧ Максим Валерьевич – Ресей Федерациясы Ауыл шаруашылығы министрлігі Халықаралық ынтымақтастық департаментінің директоры

МАРТИРОСОВА Юлия Артуровна – Федералдық ветеринариялық және фитосанитариялық қадағалау қызметі Экспорттық-импорттық операциялар кезіндегі, көліктегі ветеринариялық қадағалау және халықаралық ынтымақтастық басқармасының сыртқы ветеринариялық қадағалау және халықаралық ынтымақтастық бөлімі бастығының орынбасары

МЕДВЕДКОВ Максим Юрьевич – Ресей Федерациясы Экономикалық даму министрлігі Сауда келіссөздері департаментінің директоры (2008-2019 жылдары), Ресей Федерациясының 2-сыныпты толық шенді мемлекеттік кеңесшісі

МЕЗЕНЦЕВА Оксана Васильевна – Ресей Федерациясы Өнеркәсіп және сауда министрлігі Техникалық реттеу, стандарттау және өлшем бірліктерін қамтамасыз ету саласындағы мемлекеттік саясат департаментінің директоры

МЕРКУШОВА Татьяна Анатольевна – Федералдық кеден қызметі Талдау басқармасы Еуразиялық интеграцияны талдау бөлімінің бастығы

МИЛОВАНОВ Алексей Евгеньевич – Ресей Федерациясы Экономикалық даму министрлігі ТМД елдерімен экономикалық ынтымақтастық және Еуразиялық интеграцияны дамыту департаменті Еуразиялық экономикалық одақтағы салалық реттеу бөлімінің консультанты

МОЛЧАНОВ Артем Владимирович – Федералдық монополияға қарсы қызмет Құқықтық басқармасының бастығы

МОРОЗОВА Елена Сергеевна – Ресей Федерациясы Еңбек және әлеуметтік қорғау министрлігі Құқықтық және халықаралық қызмет департаменті директорының орынбасары – ТМД елдері бөлімінің бастығы

МУРАВЬЕВ Сергей Михайлович – Ресей Федерациясы Денсаулық сақтау министрлігі Халықаралық ынтымақтастық және жұртшылықпен байланыс департаментінің директоры

МУРАШКО Михаил Альбертович – Федералдық денсаулық саласындағы қадағалау қызметінің басшысы

НАЗАРЕНКО Валерий Петрович – Ресей Федерациясы Президенті Сыртқы саясат басқармасы бастығының орынбасары

НЕБЕНЗЯ Василий Алексеевич – Ресей Федерациясының Біріккен Ұлттар Ұйымы жанындағы Нью-Йорктегі, АҚШ-тағы Тұрақты өкілі, қоса атқаруы бойынша Ресей Федерациясының Біріккен Ұлттар Ұйымының Қауіпсіздік Кеңесіндегі Өкілі

НЕСТЕРЧУК Юлия Николаевна – Ресей Федерациясы Экономикалық даму министрлігі ТМД елдерімен экономикалық ынтымақтастық және Еуразиялық интеграцияны дамыту департаменті Еуразиялық экономикалық одақтағы салалық реттеу бөлімінің бастығы

НЕЧАЕВ Игорь Михайлович – Ресей Федерациясы Ауыл шаруашылығы министрлігі Халықаралық ынтымақтастық департаментінің ТМД және ЕАЭО бөлімінің бастығы

НИЖЕГОРОДЦЕВ Тимофей Витальевич – Федералдық монополияға қарсы қызмет Әлеуметтік саланы және сауданы бақылау басқармасының бастығы

НОВАК Александр Валентинович – Ресей Федерациясының Энергетика министрі

НОСКОВ Константин Юрьевич – Ресей Федерациясының Цифрлық даму, байланыс және бұқаралық коммуникациялар министрі

ОГРЫЗОВ Андрей Александрович – Ресей Федерациясы Үкіметі Экономика және қаржы департаментінің референті

ОЙНВИД Татьяна Николаевна – Федералдық монополияға қарсы қызмет Халықаралық экономикалық ынтымақтастық басқармасы бастығының орынбасары

ОРЕШКИН Максим Станиславович – Ресей Федерациясы Экономикалық даму министрі

ОРЛОВ Михаил Сергеевич – Федералдық тұтынушылар құқықтарын және адамның саламаттылығын қорғау саласындағы қадағалау қызметі басшысының орынбасары – статс-хатшы

ОСИПОВ Олег Сергеевич – Ресей Федерациясы Үкіметі Төрағасының баспасөз хатшысы - Ресей Федерациясы Үкіметі Аппараты басшысының орынбасары

ПАВЛОВСКИЙ Алексей Викторович – Ресей Федерациясының Австралиядағы Төтенше және Өкілетті Елшісі

ПАК Олег Борисович – Ресей Федерациясы Цифрлық даму, байланыс және бұқаралық коммуникациялар министрінің орынбасары – статс-хатшы

ПАНКИН Александр Анатольевич – Ресей Федерациясы Сыртқы істер министрінің орынбасары

ПАТРУШЕВ Дмитрий Николаевич – Ресей Федерациясының Ауыл шаруашылығы министрі

ПЕТРОВ Александр Александрович – Ресей Федерациясы Үкіметі Протокол департаменті бөлімі бастығының орынбасары

ПЕТРОВ Юрий Борисович – Ресей Федерациясы Көлік министрінің көмекшісі

ПИСУЛИНА Нина Константиновна – Ресей Федерациясы Энергетика министрлігі Мұнай мен газды өндіру және тасымалдау департаменті газ өндіру және тасымалдау бөлімінің бастығы

ПОДОЛЬСКАЯ Марина Олеговна – Ресей Федерациясы Қаржы министрлігі Халықаралық қаржы қатынастары департаментінің референті

ПОПОВА Анна Юрьевна – Федералдық тұтынушылар құқықтарын және адамның саламаттылығын қорғау саласындағы қадағалау қызметінің басшысы

ПРИВЕЗЕНЦЕВА Елена Владимировна – Федералдық монополияға қарсы қызмет Халықаралық экономикалық ынтымақтастық басқармасы ТМД елдерімен экономикалық интеграция бөлімінің бастығы

ПРИХОДЬКО Сергей Эдуардович – Ресей Федерациясы Үкіметі Аппараты басшысының бірінші орынбасары

ПУДОВ Андрей Николаевич – Ресей Федерациясы Еңбек және әлеуметтік қорғау министрінің орынбасары – статс-хатшы

ПУЗЫРЕВСКИЙ Сергей Анатольевич – Федералдық монополияға қарсы қызмет басшысының орынбасары

РОМАНОВ Филипп Александрович – Ресей Федерациясы Денсаулық сақтау министрлігі Дәрілік заттардың айналысын мемлекеттік реттеу департаментінің директоры

РОМАНОВА Татьяна Борисовна – Ресей Федерациясы Экономикалық даму министрлігі ТМД елдерімен экономикалық ынтымақтастық және Еуразиялық интеграцияны дамыту департаментінің Еуразиялық экономикалық одақтың ұлтүсті институттарын дамыту бөлімінің жетекші кеңесшісі

РУДЕНКО Андрей Юрьевич – Ресей Федерациясы Сыртқы істер министрлігі ТМД елдері Екінші департаментінің директоры

РЯБОВА Ирина Владимировна – Ресей Федерациясы Экономикалық даму министрлігі ТМД елдерімен экономикалық ынтымақтастық және Еуразиялық интеграцияны дамыту департаментінің Еуразиялық экономикалық одақтағы бірыңғай экономикалық саясат бөлімінің референті

САВЕНКОВ Константин Аркадьевич – Федералдық ветеринариялық және фитосанитариялық қадағалау қызметі басшысының орынбасары

САЗАНОВ Алексей Валерьевич – Ресей Федерациясы Қаржы министрлігінің Салық және кеден саясаты департаментінің директоры

САЛАМАТОВ Владимир Юрьевич – Федералдық аккредиттеу қызметі жанындағы Қоғамдық кеңестің төрағасы

СЕМҢНОВ Алексей Константинович – Ресей Федерациясы Көлік министрінің орынбасары

СЕНИНА Анна Ивановна – Ресей Федерациясы Қаржы министрлігінің Салық және кеден саясаты департаменті акциздер бөлімі бастығының орынбасары

СЕРЕДА Зоя Сергеевна – Ресей Федерациясы Денсаулық сақтау министрлігі Халықаралық ынтымақтастық және жұртшылықпен байланыс департаментінің денсаулық сақтау саласындағы халықаралық ынтымақтастықты дамыту бөлімінің бастығы

СИМОНЕНКО Владимир Александрович – Ресей Федерациясы Президенті Сараптау басқармасының бастығы

СИПИЛИН Станислав Сергеевич – Ресей Федерациясы Көлік министрлігінің Теңіз және өзен көлігі саласындағы мемлекеттік саясат департаменті кеме қатынасы бөлімінің бастығы

СКВОРЦОВА Вероника Игоревна – Ресей Федерациясының Денсаулық сақтау министрі

СЛЕПНЕВ Андрей Александрович – "Ресей экспорт орталығы" акционерлік қоғамының бас директоры

СМАХТИН Дмитрий Арнольдович – Ресей Федерациясы Үкіметі Халықаралық ынтымақтастық департаменті бөлімі бастығының орынбасары

СМОЛЬЯНОВ Максим Сергеевич – Ресей Федерациясы Ауыл шаруашылығы министрлігі Экономика және АӨК мемлекеттік қолдау департаменті АӨК стратегиялық дамыту және аумақтық жоспарлау бөлімінің референті

СМЫШЛЯЕВА Полина Александровна – Ресей Федерациясы Ауыл шаруашылығы министрлігі Ветеринария департаменті директорының орынбасары

СОБОЛЕВ Сергей Александрович – Ресей Федерациясы Үкіметі Төрағасы протоколының басшысы - Ресей Федерациясы Үкіметі Аппараты басшысының орынбасары

СОКОЛЬНИКОВ Сергей Михайлович – Ресей Федерациясы Экономикалық даму министрлігі Сыртқы экономикалық қызметті дамыту және реттеу департаментінің тарифтік жеңілдіктер мен преференциялар бөлімінің бастығы

СОЛОВЬЕВА Наталья Николаевна – Федералдық ветеринариялық және фитосанитариялық қадағалау қызметі Фитосанитариялық қадағалау және тұқым бақылау басқармасы бастығының орынбасары

СТЕРНИК Александр Вадимович – Ресей Федерациясы Сыртқы істер министрлігі ТМД елдері Үшінші департаментінің директоры

СТОРЧАК Сергей Анатольевич – Ресей Федерациясы Қаржы министрінің орынбасары

СТРЕЛЬНИКОВА Юлия Юрьевна – Федералдық тұтынушылар құқықтарын және адамның саламаттылығын қорғау саласындағы қадағалау қызметі Құқықтық басқармасының ақпараттық-құқықтық жұмыс және құқық қолдану практикасын талдау бөлімінің бастығы

СУХАНОВА Мария Михайловна – Федералдық денсаулық сақтау саласындағы қадағалау қызметі Медициналық бұйымдарды мемлекеттік бақылауды және тіркеуді ұйымдастыру басқармасы бастығының орынбасары

СЫСОЕВА Анна Алексеевна – Ресей Федерациясы Экономикалық даму министрлігі ТМД елдерімен экономикалық ынтымақтастық және Еуразиялық интеграцияны дамыту департаменті директорының орынбасары

СЫСОЙКИНА Галина Ивановна – Ресей Федерациясы Еңбек және әлеуметтік қорғау министрлігі Зейнетақымен қамтамасыз ету департаменті директорының орынбасары – мемлекеттік қамтамасыз ету мәселелері бөлімінің бастығы

ТАГИРОВ Эльмир Тагирович – Ресей Федерациясы Үкіметі Халықаралық ынтымақтастық департаментінің директоры

ТОКАРЕВ Владимир Александрович – Ресей Федерациясы Көлік министрінің орынбасары

ТОПИЛИН Максим Анатольевич – Ресей Федерациясының Еңбек және әлеуметтік қорғау министрі

ТРАПКОВА Алла Аркадьевна – Федералдық денсаулық сақтау саласындағы қадағалау қызметі Медициналық өнімнің сапасын мемлекеттік бақылауды ұйымдастыру басқармасы бастығының орынбасары

ТРУНИН Илья Вячеславович – Ресей Федерациясы Қаржы министрінің орынбасары

УВАЙДОВ Максим Иосифович – Ресей Федерациясы Ауыл шаруашылығы министрінің орынбасары

УРИН Алексей Борисович – Ресей Федерациясы Президенті Сараптау басқармасы департаментінің бас кеңесшісі

УСПЕНСКИЙ Владимир Евгеньевич – Ресей Федерациясы Үкіметі Экономика және қаржы департаменті бөлімі бастығының орынбасары

УШАКОВ Юрий Викторович – Ресей Федерациясы Президентінің көмекшісі

ФЕДОРОВА Анастасия Александровна – Ресей Федерациясы Экономикалық даму министрлігі ТМД елдерімен экономикалық ынтымақтастық және Еуразиялық интеграцияны дамыту департаменті Еуразиялық экономикалық одақтағы салалық реттеу бөлімінің референті

ФИЛАТОВ Артем Юрьевич – Ресей Федерациясы Үкіметі Экономика және қаржы департаменті бөлімінің бас кеңесшісі

ХЕРСОНЦЕВ Алексей Игоревич – Федералдық аккредиттеу қызметінің басшысы

ХОРОХОРДИН Алексей Юрьевич – Ресей Федерациясы Үкіметі Халықаралық ынтымақтастық департаменті бөлімінің бас кеңесшісі

ХРУЛҢВА Диана Леонидовна – Ресей Федерациясы Үкіметі Протокол департаменті бөлімінің кеңесшісі

ЦАГАРАЕВА Зарина Эдуардовна – Ресей Федерациясы Үкіметі Баспасөз қызметі және ақпарат департаменті бөлімінің консультанты

ЦВЕТКОВ Руслан Владимирович – Ресей Федерациясы Экономикалық даму министрлігі Сыртқы экономикалық қызметті дамыту және реттеу департаменті директорының орынбасары

ЦВЕТКОВ Юрий Александрович – Ресей Федерациясы Көлік министрінің орынбасары - Федералдық теңіз және өзен көлігі агенттігінің басшысы

ЦУКАНОВ Максим Валерьевич – Федералдық ветеринариялық және фитосанитариялық қадағалау қызметі Экспорттық-импорттық операциялар кезіндегі, көліктегі ветеринариялық қадағалау және халықаралық ынтымақтастық басқармасының бастығы

ЦУКАНОВА Татьяна Владимировна – Ресей Федерациясы Экономикалық даму министрлігі Сауда келіссөздері департаменті директорының орынбасары

ЦЫГАНОВ Андрей Геннадьевич – Федералдық монополияға қарсы қызмет басшысының орынбасары

ШЕРЫШЕВА Елена Ивановна – Ресей Федерациясы Көлік министрлігі Халықаралық ынтымақтастық департаменті үкіметаралық комиссиялар және ТМД елдері бөлімі бастығының орынбасары

ШИМАНОВСКАЯ Дарья Олеговна – Ресей Федерациясы Денсаулық сақтау министрлігі Халықаралық ынтымақтастық және жұртшылықпен байланыс департаменті директорының орынбасары

ШИШАЕВ Алексей Иванович – Ресей Федерациясы Президенті Сыртқы саясат басқармасы бастығының орынбасары

ШКЛЯЕВ Сергей Владимирович – Федералдық кеден қызметі Сауда шектеулері, валюталық және экспорттық бақылау басқармасының бастығы

ШУВАЛОВ Игорь Иванович – "ВЭБ.РФ" мемлекеттік даму корпорациясының төрағасы

ЩУР-ТРУХАНОВИЧ Лилия Васильевна – Ресей Федерациясы Экономикалық даму министрлігі Сыртқы экономикалық қызметті дамыту және реттеу департаментінің директоры

ЭЙВАЗОВ Тимур Рафаилович – Ресей Федерациясы Үкіметі Төрағасының Бірінші орынбасары - Ресей Федерациясының Қаржы министрі А.Г.Силуановтың Хатшылығы басшысының орынбасары

ЮДАЕВА Ксения Валентиновна – Ресей Федерациясы Орталық банкі төрағасының бірінші орынбасары

ЮРЧИК Александр Алексеевич – Ресей Федерациясы Көлік министрінің орынбасары

ЯКОВЕНКО Наталия Юрьевна – Федералдық монополияға қарсы қызмет Отын-энергетика кешенін және химия өнеркәсібін реттеу басқармасы бастығының орынбасары

ЯНОВСКИЙ Анатолий Борисович – Ресей Федерациясы Энергетика министрінің орынбасары

Еуразиялық экономикалық комиссиядан Еуразиялық экономикалық комиссияның Алқа мүшелері, Еуразиялық экономикалық комиссияның лауазымды адамдары мен қызметкерлері
АБАРБЕКОВА Аида Мырзашевна – Қаржы саясаты департаменті директорының орынбасары

АҚПАНБАЕВА Дина Қияшқызы – Өнеркәсіптік саясат департаменті директорының орынбасары

АРАМЯН Грайр Бахшоевич – Монополияға қарсы реттеу департаменті директорының орынбасары

АРУТЮНЯН Тигран Дереникович – Өнеркәсіптік саясат департаменті директорының орынбасары

БАВЕЯН Ваге Арташесович – Ішкі нарықтар, ақпараттандыру, ақпараттық-коммуникациялық технологиялар жөніндегі Алқа мүшесі (Министр) Хатшылығының басшысы

БАЙЖУМАНОВ Джанбулат – Статистика департаментінің директоры

БАЙСЕРКЕЕВ Бактыбек Закирович – Кедендік инфрақұрылым департаментінің директоры

БАЙТЕРЕКОВ Таалай Алымбекович – Ақпараттық технологиялар департаменті директорының орынбасары

БОКИТЬКО Борис Глебович – Санитариялық, фитосанитариялық және ветеринариялық шаралар департаменті санитариялық шаралар бөлімінің бастығы

БОРЦОВ Олег Васильевич – Кедендік ынтымақтастық жөніндегі Алқа мүшесінің (Министрдің) көмекшісі

БОЧАРОВА Екатерина Александровна – Кеден заңнамасы және құқық қолдану практикасы департаменті кедендік операциялар және кедендік бақылау бөлімі бастығының орынбасары

БУБЕН Станислав Брониславович – Агроөнеркәсіптік саясат департаментінің директоры

БУРМИСТРОВ Вячеслав Александрович – Техникалық реттеу және аккредиттеу департаменті директорының орынбасары

ВАЛОВАЯ Татьяна Дмитриевна – Интеграция және макроэкономика жөніндегі Алқа мүшесі (Министр)

ВАРДАНЯН Рузанна Альбертовна – Қаржы департаментінің директоры

ГАЛАНАМАТИС Александр Николаевич – Кедендік инфрақұрылым департаменті кедендік ақпараттық технологиялар бөлімінің бастығы

ГОТОВСКИЙ Александр Владиславович – Өнеркәсіптік саясат департаменті директорының орынбасары

ДЕМЕНҢВА Татьяна Александровна – Көлік және инфрақұрылым департаменті теміржол көлігі бөлімінің кеңесшісі

ЖОЛДЫБАЕВА Ғалия Тағыбердіқызы – Кәсіпкерлік қызметті дамыту департаментінің директоры

ЖҰМАБАЕВА Әлия Маратқызы – Бәсекелестік саясат және мемлекеттік сатып алу саласындағы саясат департаментінің директоры

ЕЖОВ Дмитрий Павлович – Интеграцияны дамыту департаменті халықаралық өзара іс-қимыл бөлімінің бастығы

ЕЛЕЕВА Светлана Абдурахмановна – Көлік және инфрақұрылым департаменті көлік саясаты бөлімі бастығының орынбасары

ЕНОКЯН Виген Дживанович – Алқа Төрағасының көмекшісі

ЗУЕВСКАЯ Анна Евгеньевна – Техникалық реттеу және аккредиттеу департаменті техникалық реттеу және стандарттау бөлімі бастығының орынбасары

ИСАЕВ Бакытбек Аскербекович – Монополияға қарсы реттеу департаменті директорының орынбасары

ИСПУЛЛАЕВ Ақын Имаханұлы – Санитариялық, фитосанитариялық және ветеринариялық шаралар департаменті ветеринариялық шаралар бөлімінің кеңесшісі

КАЗЕЕВА Наталья Ивановна – Техникалық реттеу және аккредиттеу департаменті сәйкестікті бағалау және өлшем бірліктерін қамтамасыз ету бөлімінің кеңесшісі

ҚАЛИАСҚАРОВА Тоты Рысбекқызы – Макроэкономикалық саясат департаментінің директоры

КОЗАЕВ Вадим Русланович – Кеден заңнамасы және құқық қолдану практикасы департаменті тәуекелдерді талдау және постбақылау бөлімінің бастығы

КОРОТКОВ Олег Геннадьевич – Қаржы департаменті төлемдер және бюджет саясаты саласындағы үйлестіру бөлімі бастығының орынбасары

КРАВЦОВА Наталия Валерьевна – Кедендік-тарифтік реттеу және тарифтік емес реттеу департаменті СЭҚ ТН және кедендік құн бөлімінің бастығы

КТИКЯН Виген Григорьевич – Алқа Төрағасы Хатшылығының басшысы

КУЗЬМИЧ Людмила Анатольевна – Кедендік ынтымақтастық жөніндегі Алқа мүшесінің (Министрдің) көмекшісі

ҚҰСАЙЫНОВА Айна Біржанқызы – Агроөнеркәсіптік саясат департаменті директорының орынбасары

КУШНАРЕВ Николай Геннадиевич – Өнеркәсіптік саясат департаментінің директоры

ЛЯХОВА Наталья Владимировна – Кедендік-тарифтік реттеу және тарифтік емес реттеу департаменті директорының орынбасары

МАНУИЛОВА Виктория Ивановна – Бәсекелестік саясат және мемлекеттік сатып алу саласындағы саясат департаменті халықаралық ынтымақтастық бөлімінің кеңесшісі

МАСЛИЙ Алексей Викторович – Энергетика және инфрақұрылым жөніндегі Алқа мүшесі (Министр) Хатшылығының кеңесшісі

МИНАСЯН Карине Агасиевна – Ішкі нарықтар, ақпараттандыру, ақпараттық-коммуникациялық технологиялар жөніндегі Алқа мүшесі (Министр)

МИНАШКИНА Наталья Валерьевна – Ішкі нарықты қорғау департаменті қорғау шаралары бойынша дауларды сүйемелдеу бөлімі бастығының орынбасары

МЫСКИН Михаил Евгеньевич – Сауда саясаты департаменті сауда келіссөздерін талдамалық қолдау және іскерлік қоғамдастықпен өзара іс-қимыл бөлімінің бастығы

НИКИШИНА Вероника Олеговна – Сауда жөніндегі Алқа мүшесі (Министр)

ПАНТЕЛЕЕВ Андрей Алексеевич – Макроэкономикалық саясат департаменті экономикалық саясат стратегиялары бөлімінің бастығы

ПЕТРОВ Александр Владимирович – Ішкі нарықтар, ақпараттандыру, ақпараттық-коммуникациялық технологиялар жөніндегі Алқа мүшесінің (Министрдің) көмекшісі

ПОПОВ Дмитрий Игоревич – Сауда саясаты департаменті тауарлар саудасының қағидалары мен шарттары бөлімінің бастығы

РАХМЕТОВА Нұрия Ғалымқызы – Энергетика департаменті мұнай-газ саясаты бөлімі бастығының орынбасары

РОЖДЕСТВЕНСКИЙ Дмитрий Анатольевич – Техникалық реттеу және аккредиттеу департаменті дәрілік заттар мен медициналық бұйымдардың айналысы саласындағы жұмыстарды үйлестіру бөлімінің бастығы

РОТОВ Михаил Сергеевич – Көлік және инфрақұрылым департаменті автомобиль көлігі бөлімі бастығының орынбасары

САВОСТЬЯН Сергей Валерьевич – Ішкі нарықтардың жұмыс істеу департаменті сараптама және медиация бөлімінің бастығы

САРКИСЯН Тигран Суренович – Алқа Төрағасы

САРУХАНЯН Севак Норайрович – Алқа Төрағасының көмекшісі

СУББОТИН Александр Михайлович – Өнеркәсіп және агроөнеркәсіптік кешен жөніндегі Алқа мүшесі (Министр)

СУЮМБАЕВА Паиза Усенбаевна – Еңбек көші-қоны және әлеуметтік қорғау департаментінің директоры

ТАРАСКИН Владимир Иванович – Құқықтық департаменттің директоры

ТУРУСБЕКОВ Данияр Бактыбекович – Протокол және ұйымдастырушылық қамтамасыз ету департаментінің директоры

УНАНЯН Лиана Александровна – Істерді басқару департаментінің директоры

ФИЛОНОВ Анатолий Васильевич – Бәсекелестік саясат және мемлекеттік сатып алу саласындағы саясат департаменті директорының орынбасары

ХАЧАТРЯН Арман Генрикович – Қаржы саясаты департаментінің директоры

ХОРШЕВ Дмитрий Юрьевич – Ішкі нарықтардың жұмыс істеу департаменті мониторинг және ақпараттық өзара іс-қимыл бөлімінің бастығы

ЧАЛАЯ Юлия Юрьевна – Алқа Төрағасының көмекшісі

ЧЕРНИЦЫН Федор Валентинович – Интеграция және макроэкономика жөніндегі Алқа мүшесінің (Министрдің) көмекшісі

ЧЕСНОКОВА Татьяна Николаевна – Бәсекелестік саясат және мемлекеттік сатып алу саласындағы саясат департаменті құқықтық қамтамасыз ету және бәсекелестік саласындағы әдіснама бөлімінің бастығы

ШЕНЕЦ Леонид Васильевич – Энергетика департаментінің директоры

ШИШОВ Юрий Владимирович – Ішкі нарықты қорғау департаменті импортты талдау бөлімі бастығының орынбасары

ШУХНО Сергей Степанович – Интеграцияны дамыту департаментінің директоры

Еуразиялық экономикалық одаққа мүше мемлекеттердің азаматтары
АЛПЫСБАЕВА Сара Нұрбекқызы (Қазақстан Республикасы) – "Экономикалық зерттеулер институты" акционерлік қоғамы Макроэкономикалық және қолданбалы экономикалық-математикалық зерттеулер орталығының директоры

БАТЫРШИН Радик Ирикович (Ресей Федерациясы) – мемлекетаралық "Мир" телерадиокомпаниясының төрағасы

БЕЙШЕНОВ Жанат Саматович (Қырғыз Республикасы) – Қырғыз Республикасы Көлік және жолдар министрі

БЕЛЬЯНИНОВ Андрей Юрьевич (Ресей Федерациясы) – Еуразиялық даму банкі басқармасының төрағасы

БЫСТРИЦКИЙ Андрей Георгиевич (Ресей Федерациясы) – "Валдай" халықаралық пікірсайыс клубын дамыту және қолдау қоры кеңесінің төрағасы, "Экономика жоғары мектебі" ұлттық зерттеу университетінің коммуникациялар, медиа және дизайн факультетінің деканы

ГЛУЩЕНКО Кирилл Иванович (Беларусь Республикасы) – Беларусь Республикасы Ауыл шаруашылығы және азық-түлік министрлігі Ветеринариялық және азық-түлік қадағалау департаменті директорының бірінші орынбасары

КАДОЧНИКОВ Павел Анатольевич (Ресей Федерациясы) – Бүкілресейлік сыртқы сауда академиясының ғылыми жұмыс жөніндегі проректоры, Е.Т.Гайдар атындағы Экономикалық саясат институты "Нақты сектор" ғылыми бағытының жетекші ғылыми қызметкері, "Жаңа экономикалық білім" қорының директоры

КАРАГАНОВ Сергей Александрович (Ресей Федерациясы) – "Экономика жоғары мектебі" ұлттық зерттеу университетінің әлемдік экономика және әлемдік саясат факультетінің деканы

ЛЕБЕДЕВ Сергей Николаевич (Ресей Федерациясы) – Тәуелсіз Мемлекеттер Достастығының Атқарушы хатшысы – Атқару комитетінің төрағасы

НАУМОВ Станислав Александрович (Ресей Федерациясы) – Еуразиялық интеграциялық зерттеулер мен коммуникациялар орталығының атқарушы директоры

ПАНКИН Дмитрий Владимирович (Ресей Федерациясы) – Еуразиялық даму банкі басқармасының төрағасы (2015-2017 жылдары)

ПИВОВАР Эдуард Анатольевич (Беларусь Республикасы) – "БелТА" ақпарат агенттігінің меншікті тілшісі

РАПОТА Григорий Алексеевич (Ресей Федерациясы) – Одақтық мемлекеттің Мемлекеттік хатшысы

РАСПОПОВ Владимир Владимирович (Ресей Федерациясы) – Өнеркәсіпті дамыту қоры директорының орынбасары

ХРИСТЕНКО Виктор Борисович (Ресей Федерациясы) – Еуразиялық экономикалық одақтың Іскерлік кеңесінің президенті

ШЕВЦОВ Юрий Анатольевич (Беларусь Республикасы) – Еуропалық интеграция проблемалары орталығының директоры (Минск)

ШОХИН Александр Николаевич (Ресей Федерациясы) – Ресей өнеркәсіпшілері мен кәсіпкерлері одағының президенті

Еуразиялық экономикалық одақ Сотынан
АЖИБРАИМОВА Айжамал Мусуратбековна – судья

АЙРИЯН Эрна Владимировна – Сот Төрағасының орынбасары

БӘЙІШЕВ Жолымбет Нұрахметұлы – Сот Төрағасы

КОЛОС Денис Георгиевич – судья

НЕШАТАЕВА Татьяна Николаевна – судья

СЕЙТІМОВА Венера Хамитқызы – судья

СКРИПКИНА Галина Анатольевна – судья

ТУМАНЯН Армен Эдуардович – судья

ФЕДОРЦОВ Александр Адамович – судья

ЧАЙКА Константин Леонтьевич – судья

Үшінші мемлекетерден
ПРОДИ Романо (Сан-Марино Республикасы) – Прагмата Институтының басшысы

РАССЕЛЛ Дэниел А. (Америка Құрама Штаттары) – Америка-Ресей іскерлік кеңесінің президенті және бас директоры

РОДЗЯНКО Алексис (Америка Құрама Штаттары) – Ресейдегі Америка сауда палатасының президенті

ФАЛИКО Антонио (Италия Республикасы) – Интеза Банкі Директорлар кеңесінің төрағасы, Ресей Федерациясындағы Интеза Санпаоло Тобы Өкілдігінің басшысы

ШЕПП Маттиас (ГФР) – Ресей-Герман сыртқы сауда палатасы басқармасының төрағасы

